,datetime,symbol,Open,High,Low,Close,Volume,Dividends,Stock Splits,change_in_price,down_days,up_days,RSI,low_14,high_14,k_percent,r_percent,MACD,MACD_EMA,Price_Rate_Of_Change,On Balance Volume,Prediction
333,2023-01-23,AMD,72.22000122070312,76.58999633789062,71.54000091552734,76.52999877929688,84293200.0,0.0,0.0,6.459999084472656,0.0,6.459999084472656,78.06401883831799,60.04999923706055,76.58999633789062,99.63725774419429,-0.3627422558057097,0.9507182362301876,0.6115204349619795,0.13816182645260033,430607000.0,1.0
334,2023-01-24,AMD,73.75,75.63999938964844,73.41999816894531,74.69999694824219,60822600.0,0.0,0.0,-1.8300018310546875,1.8300018310546875,0.0,68.43234228904547,60.04999923706055,76.58999633789062,88.5731576727206,-11.426842327279402,1.110241923684427,0.714902153560834,0.0977221689678176,369784400.0,-1.0
335,2023-01-25,AMD,72.9000015258789,75.12000274658203,72.08999633789062,74.91000366210938,49932600.0,0.0,0.0,0.2100067138671875,0.0,0.2100067138671875,68.93978268333655,60.04999923706055,76.58999633789062,89.84284782192049,-10.15715217807951,1.2300698176768918,0.8209198183569871,0.08470904011475255,419717000.0,1.0
336,2023-01-26,AMD,76.5,77.08000183105469,74.27999877929688,75.16000366210938,49583900.0,0.0,0.0,0.25,0.0,0.25,69.61077422992956,60.04999923706055,77.08000183105469,88.72579050796841,-11.274209492031586,1.3216613623788902,0.9233752176517988,0.06158192687031683,469300900.0,1.0
337,2023-01-27,AMD,73.69999694824219,76.73999786376953,73.48999786376953,75.4000015258789,58118600.0,0.0,0.0,0.23999786376953125,0.0,0.23999786376953125,70.32096912864966,65.66999816894531,77.08000183105469,85.27607567073122,-14.723924329268781,1.3907125089646115,1.0185573243147599,0.061971852477167744,527419500.0,1.0
338,2023-01-30,AMD,74.2300033569336,74.63999938964844,72.4000015258789,72.44999694824219,48105200.0,0.0,0.0,-2.9500045776367188,2.9500045776367188,0.0,52.81523434435654,66.55999755859375,77.08000183105469,55.98856461557875,-44.01143538442125,1.2376241538037505,1.0630113400970775,0.012012860096996425,479314300.0,-1.0
339,2023-01-31,AMD,72.26000213623047,75.19999694824219,72.02999877929688,75.1500015258789,71669100.0,0.0,0.0,2.7000045776367188,0.0,2.7000045776367188,62.63766953392162,67.18000030517578,77.08000183105469,80.5050504272075,-19.494949572792507,1.2806950504228354,1.107055881147606,0.06550408090944382,550983400.0,1.0
340,2023-02-01,AMD,78.47000122070312,85.4800033569336,77.87999725341797,84.63999938964844,152548200.0,0.0,0.0,9.489997863769531,0.0,9.489997863769531,79.7410898521399,67.18000030517578,85.4800033569336,95.40981515189164,-4.590184848108369,1.9264745464632682,1.2724652463241415,0.25003693005599503,703531600.0,1.0
341,2023-02-02,AMD,84.29000091552734,88.94000244140625,83.19999694824219,88.30999755859375,97762100.0,0.0,0.0,3.6699981689453125,0.0,3.6699981689453125,83.17738301501106,67.2699966430664,88.94000244140625,97.09273320609464,-2.9072667939053582,2.6496590920140193,1.5499515026438377,0.2603110881006161,801293700.0,1.0
342,2023-02-03,AMD,86.66000366210938,88.80000305175781,85.83000183105469,86.08999633789062,66557800.0,0.0,0.0,-2.220001220703125,2.220001220703125,0.0,74.37253276804508,67.2699966430664,88.94000244140625,86.8481525568675,-13.151847443132509,3.0282884089251354,1.8473745597452074,0.12491830277122573,734735900.0,-1.0
343,2023-02-06,AMD,84.62999725341797,86.27999877929688,83.22000122070312,83.68000030517578,53008900.0,0.0,0.0,-2.4099960327148438,2.4099960327148438,0.0,65.66559170318877,67.2699966430664,88.94000244140625,75.72680789668527,-24.27319210331472,3.120938110786156,2.1032958239537494,0.12021423994375291,681727000.0,-1.0
344,2023-02-07,AMD,84.31999969482422,86.25,82.5199966430664,85.91000366210938,65291900.0,0.0,0.0,2.2300033569335938,0.0,2.2300033569335938,69.48037070344998,67.2699966430664,88.94000244140625,86.01754513822509,-13.982454861774912,3.3112867674391993,2.3458102060826627,0.14684287094173465,747018900.0,1.0
345,2023-02-08,AMD,85.87999725341797,88.0,84.54000091552734,84.69000244140625,54140400.0,0.0,0.0,-1.220001220703125,1.220001220703125,0.0,64.92665905224183,67.44999694824219,88.94000244140625,80.22336475738958,-19.776635242610425,3.3349936542601455,2.544246633018346,0.12679614575512943,692878500.0,-1.0
346,2023-02-09,AMD,85.87999725341797,86.66999816894531,82.76000213623047,83.20999908447266,46525400.0,0.0,0.0,-1.4800033569335938,1.4800033569335938,0.0,59.47086466302529,71.54000091552734,88.94000244140625,67.06894911238142,-32.93105088761859,3.2095889367141126,2.6776376133579713,0.10358086738119221,646353100.0,-1.0
347,2023-02-10,AMD,82.29000091552734,82.70999908447266,80.47000122070312,81.4800033569336,49332600.0,0.0,0.0,-1.7299957275390625,1.7299957275390625,0.0,53.41685023297569,72.02999877929688,88.94000244140625,55.88410722116848,-44.11589277883153,2.9506952079292432,2.7323549710345874,0.12463777486619332,597020500.0,-1.0
348,2023-02-13,AMD,81.56999969482422,84.1500015258789,80.9000015258789,83.12999725341797,45400000.0,0.0,0.0,1.649993896484375,0.0,1.649993896484375,58.10971197246114,72.02999877929688,88.94000244140625,65.64160893112701,-34.358391068872976,2.833325631946863,2.7525804005533088,0.10618756574197863,642420500.0,1.0
349,2023-02-14,AMD,82.69999694824219,86.19000244140625,81.7699966430664,85.94999694824219,55979700.0,0.0,0.0,2.8199996948242188,0.0,2.8199996948242188,65.05257664511001,72.02999877929688,88.94000244140625,82.31812628246891,-17.68187371753109,2.913631702739309,2.784830584784843,0.015477286956998348,698400200.0,1.0
350,2023-02-15,AMD,85.0999984741211,85.88999938964844,83.31999969482422,85.18000030517578,46430200.0,0.0,0.0,-0.7699966430664062,0.7699966430664062,0.0,61.82428944159081,72.02999877929688,88.94000244140625,77.7646284923309,-22.235371507669097,2.886280074387699,2.805140596767039,-0.035443294530058345,651970000.0,-1.0
351,2023-02-16,AMD,82.9800033569336,83.3499984741211,80.05000305175781,80.08000183105469,57755200.0,0.0,0.0,-5.099998474121094,5.099998474121094,0.0,44.824253252850255,72.02999877929688,88.94000244140625,47.60497521236873,-52.39502478763127,2.4561076776229953,2.7352786626115018,-0.06981060242176795,594214800.0,-1.0
352,2023-02-17,AMD,79.5999984741211,79.6500015258789,77.37000274658203,78.5,47826600.0,0.0,0.0,-1.5800018310546875,1.5800018310546875,0.0,40.81262491094592,72.02999877929688,88.94000244140625,38.26138272932845,-61.73861727067155,1.9745039564257496,2.583027220558399,-0.061902489080839396,546388200.0,-1.0
353,2023-02-21,AMD,77.1500015258789,78.45999908447266,76.44999694824219,76.7699966430664,44045600.0,0.0,0.0,-1.7300033569335938,1.7300033569335938,0.0,36.66674045367319,76.44999694824219,88.94000244140625,2.5620460695502385,-97.43795393044977,1.4463619763856315,2.3555788416942502,-0.10639048573424947,502342600.0,-1.0
354,2023-02-22,AMD,76.93000030517578,78.12999725341797,75.91999816894531,76.61000061035156,50286800.0,0.0,0.0,-0.15999603271484375,0.15999603271484375,0.0,36.27353214268269,75.91999816894531,88.94000244140625,5.299556182678819,-94.70044381732117,1.0046851189125476,2.085290455142567,-0.09540679653002648,452055800.0,-1.0
355,2023-02-23,AMD,80.62999725341797,81.79000091552734,77.97000122070312,79.75,76391300.0,0.0,0.0,3.1399993896484375,0.0,3.1399993896484375,48.72508669058883,75.91999816894531,88.80000305175781,29.736027788045078,-70.26397221195492,0.8837573402661008,1.8449058228940947,-0.04158153013510013,528447100.0,1.0
356,2023-02-24,AMD,77.75,78.80999755859375,76.94000244140625,78.08999633789062,46700000.0,0.0,0.0,-1.660003662109375,1.660003662109375,0.0,43.53612047308738,75.91999816894531,88.0,17.963558278333913,-82.03644172166608,0.6535982415805677,1.6065824343423047,-0.041605386344826356,481747100.0,-1.0
357,2023-02-27,AMD,79.63999938964844,80.12000274658203,78.52999877929688,78.7699966430664,45617300.0,0.0,0.0,0.6800003051757812,0.0,0.6800003051757812,46.24206428652445,75.91999816894531,88.0,23.5926990242208,-76.40730097577921,0.517556615749811,1.3887320248639354,-0.052447982129246284,527364400.0,1.0
358,2023-02-28,AMD,77.87000274658203,80.13999938964844,77.41999816894531,78.58000183105469,44220100.0,0.0,0.0,-0.18999481201171875,0.18999481201171875,0.0,45.53849435772092,75.91999816894531,88.0,22.019894527426025,-77.98010547257397,0.39068062572985696,1.1890885735790417,-0.08574747386699266,483144300.0,-1.0
359,2023-03-01,AMD,78.55000305175781,80.29000091552734,77.87999725341797,78.29000091552734,44266000.0,0.0,0.0,-0.29000091552734375,0.29000091552734375,0.0,44.3500743852142,75.91999816894531,86.66999816894531,22.04653717750727,-77.95346282249274,0.26473560055866585,1.0041934021911572,-0.08088752482934403,438878300.0,-1.0
360,2023-03-02,AMD,77.56999969482422,80.91999816894531,76.6500015258789,80.44000244140625,60108600.0,0.0,0.0,2.1500015258789062,0.0,2.1500015258789062,54.50625220465682,75.91999816894531,86.19000244140625,44.01170780991152,-55.98829219008847,0.32788061930025947,0.8689164605011315,0.004495512014485836,498986900.0,1.0
361,2023-03-03,AMD,80.4000015258789,81.62999725341797,79.33999633789062,81.5199966430664,54536200.0,0.0,0.0,1.0799942016601562,0.0,1.0799942016601562,58.85816268200282,75.91999816894531,86.19000244140625,54.52771318837242,-45.472286811627576,0.45657118120213624,0.7864403883530713,0.03847129481613254,553523100.0,1.0
362,2023-03-06,AMD,82.02999877929688,83.30000305175781,81.04000091552734,81.16000366210938,54541300.0,0.0,0.0,-0.35999298095703125,0.35999298095703125,0.0,56.76952080345989,75.91999816894531,86.19000244140625,51.02242758764143,-48.97757241235857,0.524346800521883,0.7340181031109734,0.05718388968354171,498981800.0,-1.0
363,2023-03-07,AMD,81.06999969482422,84.8499984741211,80.66999816894531,82.11000061035156,70959000.0,0.0,0.0,0.9499969482421875,0.0,0.9499969482421875,60.98515790410574,75.91999816894531,85.88999938964844,62.086275662157895,-37.9137243378421,0.6448208541724938,0.7161776819983617,0.07179219365855016,569940800.0,1.0
364,2023-03-08,AMD,82.79000091552734,85.7699966430664,82.27999877929688,85.37000274658203,69529800.0,0.0,0.0,3.2600021362304688,0.0,3.2600021362304688,71.85310007104397,75.91999816894531,85.7699966430664,95.93914762996889,-4.060852370031114,0.9842935209874923,0.7698031855162858,0.07047025387563677,639470600.0,1.0
365,2023-03-09,AMD,85.29000091552734,87.80999755859375,83.58999633789062,84.02999877929688,79496700.0,0.0,0.0,-1.3400039672851562,1.3400039672851562,0.0,63.46799770706724,75.91999816894531,87.80999755859375,68.20858727219294,-31.79141272780706,1.1348384653125976,0.8428127854888076,0.07606611243396944,559973900.0,-1.0
366,2023-03-10,AMD,84.47000122070312,85.44999694824219,81.62999725341797,82.66999816894531,70273600.0,0.0,0.0,-1.3600006103515625,1.3600006103515625,0.0,55.83723901748173,75.91999816894531,87.80999755859375,56.770398204365115,-43.22960179563488,1.133957436323115,0.9010433388865866,0.04951125672318013,489700300.0,-1.0
367,2023-03-13,AMD,81.38999938964844,83.83000183105469,78.5199966430664,82.01000213623047,65269100.0,0.0,0.0,-0.6599960327148438,0.6599960327148438,0.0,52.315224480551414,75.91999816894531,87.80999755859375,51.21954819095432,-48.78045180904568,1.0688604044214713,0.9346075004993795,0.043649786526477996,424431200.0,-1.0
368,2023-03-14,AMD,83.66999816894531,88.30000305175781,83.58999633789062,87.44999694824219,66616300.0,0.0,0.0,5.439994812011719,0.0,5.439994812011719,70.19498301893906,76.6500015258789,88.30000305175781,92.70381122588309,-7.296188774116906,1.430349348574822,1.0337576390120484,0.11700084206919614,491047500.0,1.0
369,2023-03-15,AMD,86.7699966430664,90.41999816894533,86.22000122070312,89.68000030517578,86177400.0,0.0,0.0,2.2300033569335938,0.0,2.2300033569335938,74.68470841370092,76.6500015258789,90.41999816894533,94.62601275112034,-5.373987248879651,1.871495077409108,1.2013075180432429,0.11486819472065646,577224900.0,1.0
370,2023-03-16,AMD,89.72000122070312,96.69000244140624,89.0199966430664,96.5999984741211,115839200.0,0.0,0.0,6.9199981689453125,0.0,6.9199981689453125,83.55466507215196,76.6500015258789,96.69000244140624,99.55087842727889,-0.44912157272111425,2.737539259187187,1.508557374445221,0.1849853097649421,693064100.0,1.0
371,2023-03-17,AMD,96.66000366210938,98.75,95.94000244140624,97.83999633789062,94080800.0,0.0,0.0,1.2399978637695312,0.0,1.2399978637695312,84.66555132903679,76.6500015258789,98.75,95.8823360862446,-4.117663913755385,3.481835598772008,1.903216624280202,0.20551986105402964,787144900.0,1.0
372,2023-03-20,AMD,96.3000030517578,96.94000244140624,92.9000015258789,96.80999755859376,92008900.0,0.0,0.0,-1.0299987792968608,1.0299987792968608,0.0,79.51738421371995,76.6500015258789,98.75,91.22170780383554,-8.778292196164456,3.944175450804721,2.3114113724715697,0.1790280944948499,695136000.0,-1.0
373,2023-03-21,AMD,97.0,99.45999908447266,93.63999938964844,95.93000030517578,85285300.0,0.0,0.0,-0.879997253417983,0.879997253417983,0.0,75.02043496157101,76.6500015258789,99.45999908447266,84.52433512879998,-15.47566487120002,4.19209481930217,2.6875502607480946,0.12369681643259112,609850700.0,-1.0
374,2023-03-22,AMD,95.6500015258789,101.6999969482422,95.63999938964844,97.58000183105467,110816300.0,0.0,0.0,1.650001525878892,0.0,1.650001525878892,77.7435318012958,78.5199966430664,101.6999969482422,82.22607824440973,-17.773921755590255,4.468267275216164,3.0436953292628304,0.16125197249314027,720667000.0,1.0
375,2023-03-23,AMD,100.0500030517578,102.43000030517578,98.66999816894533,100.27999877929688,84088900.0,0.0,0.0,2.6999969482422017,0.0,2.6999969482422017,81.54258899341728,78.5199966430664,102.43000030517578,91.00794146139738,-8.992058538602626,4.846274991271883,3.4042126105199286,0.21301561631056987,804755900.0,1.0
376,2023-03-24,AMD,99.18000030517578,99.5199966430664,96.73999786376952,97.9499969482422,64712400.0,0.0,0.0,-2.3300018310546733,2.3300018310546733,0.0,69.69658260095306,78.5199966430664,102.43000030517578,81.26305867517235,-18.736941324827665,4.903332154776024,3.704037416793372,0.19436647234239923,740043500.0,-1.0
377,2023-03-27,AMD,98.0199966430664,98.93000030517578,95.43000030517578,96.61000061035156,57461400.0,0.0,0.0,-1.3399963378906392,1.3399963378906392,0.0,63.568499029397046,78.5199966430664,102.43000030517578,75.65872520526929,-24.341274794730708,4.78630319896763,3.9204910915318036,0.10474561442844621,682582100.0,-1.0
378,2023-03-28,AMD,96.7699966430664,96.94000244140624,92.87000274658205,94.55999755859376,59150100.0,0.0,0.0,-2.0500030517577983,2.0500030517577983,0.0,55.027787564362946,78.5199966430664,102.43000030517578,67.08489526894654,-32.915104731053454,4.478083037230135,4.032009694298671,0.05441566945597276,623432000.0,-1.0
379,2023-03-29,AMD,96.06999969482422,96.91000366210938,94.87000274658205,96.08999633789062,55326000.0,0.0,0.0,1.5299987792968608,0.0,1.5299987792968608,59.69151395278603,78.5199966430664,102.43000030517578,73.48388541933902,-26.51611458066097,4.306455581171122,4.086898955790709,-0.005279525303171662,678758000.0,1.0
380,2023-03-30,AMD,98.0,99.52999877929688,97.25,97.87999725341795,59678500.0,0.0,0.0,1.7900009155273295,0.0,1.7900009155273295,64.64138745682482,78.5199966430664,102.43000030517578,80.97029546269664,-19.029704537303356,4.264441298223915,4.12240746781066,0.0004088401167676725,738436500.0,1.0
381,2023-03-31,AMD,96.33999633789062,98.36000061035156,95.2699966430664,98.01000213623048,55861100.0,0.0,0.0,0.13000488281252842,0.0,0.13000488281252842,65.00155180437304,83.58999633789062,102.43000030517578,76.53929279091219,-23.46070720908781,4.193157919798665,4.136557572086643,0.012395461294278265,794297600.0,1.0
382,2023-04-03,AMD,96.6999969482422,96.79000091552734,94.80999755859376,96.55999755859376,50655300.0,0.0,0.0,-1.4500045776367188,1.4500045776367188,0.0,57.46816218079079,86.22000122070312,102.43000030517578,63.787766328717346,-36.212233671282654,3.9746464598623987,4.104175324233461,0.006567259995974295,743642300.0,-1.0
383,2023-04-04,AMD,97.04000091552734,97.2699966430664,95.20999908447266,95.87000274658205,43195900.0,0.0,0.0,-0.6899948120117188,0.6899948120117188,0.0,54.03000243987212,89.0199966430664,102.43000030517578,51.08131418987355,-48.91868581012645,3.7034488846457805,4.02402998600788,-0.017524073092694104,700446400.0,-1.0
384,2023-04-05,AMD,94.3499984741211,94.5,91.36000061035156,92.55999755859376,52979300.0,0.0,0.0,-3.3100051879882812,3.3100051879882812,0.0,40.58885609364332,91.36000061035156,102.43000030517578,10.840081132100307,-89.15991886789969,3.186346928895432,3.8564932904538,-0.07698445666811204,647467100.0,-1.0
385,2023-04-06,AMD,91.47000122070312,92.91000366210938,90.62000274658205,92.47000122070312,47778400.0,0.0,0.0,-0.08999633789063921,0.08999633789063921,0.0,40.27453327617125,90.62000274658205,102.43000030517578,15.664681257913541,-84.33531874208646,2.7377592117533993,3.6327463848268664,-0.05594686981393948,599688700.0,-1.0
386,2023-04-10,AMD,91.31999969482422,95.8000030517578,91.0199966430664,95.4800033569336,52536300.0,0.0,0.0,3.0100021362304688,0.0,3.0100021362304688,54.0167948128061,90.62000274658205,102.43000030517578,41.1515801441897,-58.8484198558103,2.593929186691412,3.42498287842716,-0.011696483244788336,652225000.0,1.0
387,2023-04-11,AMD,96.05999755859376,96.06999969482422,92.69000244140624,94.02999877929688,51935800.0,0.0,0.0,-1.4500045776367188,1.4500045776367188,0.0,47.89174287413805,90.62000274658205,102.43000030517578,28.873808108736576,-71.12619189126342,2.336569102980107,3.2073000673693026,-0.0056048941728078505,600289200.0,-1.0
388,2023-04-12,AMD,94.97000122070312,95.0,91.73999786376952,92.33000183105467,53383100.0,0.0,0.0,-1.6999969482422017,1.6999969482422017,0.0,41.522457735415145,90.62000274658205,102.43000030517578,14.479250109821736,-85.52074989017827,1.973309352664245,2.9605018736648474,-0.03912992663267789,546906100.0,-1.0
389,2023-04-13,AMD,92.79000091552734,93.16000366210938,91.83000183105467,92.08999633789062,40572500.0,0.0,0.0,-0.2400054931640483,0.2400054931640483,0.0,40.641965165220334,90.62000274658205,99.52999877929688,16.498251917410563,-83.50174808258943,1.6471528767190478,2.6978320310532453,-0.05915407721698873,506333600.0,-1.0
390,2023-04-14,AMD,91.81999969482422,92.97000122070312,90.5,91.75,38734800.0,0.0,0.0,-0.339996337890625,0.339996337890625,0.0,39.28045733403559,90.5,99.52999877929688,13.84274827219115,-86.15725172780884,1.3458323770178708,2.4274320646506204,-0.06387105397191295,467598800.0,-1.0
391,2023-04-17,AMD,90.2300033569336,90.69000244140624,88.30000305175781,89.87000274658203,47250800.0,0.0,0.0,-1.8799972534179688,1.8799972534179688,0.0,32.36328068747362,88.30000305175781,99.52999877929688,13.980412218449418,-86.01958778155058,0.9449957554779189,2.1309447715923238,-0.06928329516528997,420348000.0,-1.0
392,2023-04-18,AMD,91.61000061035156,92.16000366210938,89.33000183105469,89.77999877929688,46246300.0,0.0,0.0,-0.09000396728515625,0.09000396728515625,0.0,32.05149728049608,88.30000305175781,99.52999877929688,13.17895183085157,-86.82104816914843,0.61303352543068,1.827362496783239,-0.06352356099731404,374101700.0,-1.0
393,2023-04-19,AMD,88.51000213623047,90.54000091552734,88.22000122070312,89.94000244140625,37344500.0,0.0,0.0,0.160003662109375,0.0,0.160003662109375,33.36823106263708,88.22000122070312,99.52999877929688,15.207794800947639,-84.79220519905236,0.3586942839821745,1.5336288344254163,-0.02830591169288832,411446200.0,1.0
394,2023-04-20,AMD,88.83000183105469,91.58000183105467,88.7300033569336,90.11000061035156,47082700.0,0.0,0.0,0.1699981689453125,0.0,0.1699981689453125,34.91442880531007,88.22000122070312,98.36000061035156,18.639048357121897,-81.36095164287809,0.16886560274687668,1.26067617337213,-0.0255217971147077,458528900.0,1.0
395,2023-04-21,AMD,89.80000305175781,89.80000305175781,88.05999755859375,88.43000030517578,41118300.0,0.0,0.0,-1.6800003051757812,1.6800003051757812,0.0,27.608977657961248,88.05999755859375,97.2699966430664,4.017402642371889,-95.98259735762811,-0.11543864891572753,0.9854531970425637,-0.07383748223596864,417410600.0,-1.0
396,2023-04-24,AMD,88.11000061035156,88.63999938964844,86.33999633789062,87.56999969482422,40423800.0,0.0,0.0,-0.8600006103515625,0.8600006103515625,0.0,24.572134959550965,86.33999633789062,97.2699966430664,11.253461322879737,-88.74653867712027,-0.40529464641949176,0.7073036187515634,-0.0687014694069632,376986800.0,-1.0
397,2023-04-25,AMD,86.9000015258789,87.05999755859375,83.76000213623047,83.80000305175781,52771500.0,0.0,0.0,-3.7699966430664062,3.7699966430664062,0.0,15.788127349896243,83.76000213623047,96.06999969482422,0.32494657563452284,-99.67505342436547,-0.9278123117978225,0.3802804236135618,-0.09238599166178985,324215300.0,-1.0
398,2023-04-26,AMD,86.51000213623047,87.3499984741211,85.31999969482422,85.94000244140625,47786600.0,0.0,0.0,2.1399993896484375,0.0,2.1399993896484375,31.764577512411634,83.76000213623047,96.06999969482422,17.709185520137638,-82.29081447986236,-1.156254519852908,0.07297342813321213,-0.06678243176293785,372001900.0,1.0
399,2023-04-27,AMD,86.41000366210938,87.56999969482422,84.08999633789062,87.44000244140625,53087200.0,0.0,0.0,1.5,0.0,1.5,40.841699452868525,83.76000213623047,96.06999969482422,29.89440320893265,-70.10559679106734,-1.2026253685567951,-0.18214633571236533,-0.04697545022990468,425089100.0,1.0
400,2023-04-28,AMD,87.0199966430664,89.75,86.44000244140625,89.37000274658203,50652100.0,0.0,0.0,1.9300003051757812,0.0,1.9300003051757812,50.59821894973255,83.76000213623047,96.06999969482422,45.57271911427112,-54.42728088572888,-1.071566254825072,-0.36003032204925695,-0.00556359168486853,475741200.0,1.0
401,2023-05-01,AMD,91.02999877929688,91.04000091552734,88.61000061035156,89.69000244140625,59358700.0,0.0,0.0,0.31999969482421875,0.0,0.31999969482421875,52.10924180460714,83.76000213623047,95.0,52.7580198595078,-47.24198014049221,-0.9311880174409026,-0.47426186241929585,-0.0010024096582119668,535099900.0,1.0
402,2023-05-02,AMD,89.31999969482422,90.45999908447266,88.12000274658203,89.91000366210938,70483500.0,0.0,0.0,0.220001220703125,0.0,0.220001220703125,53.24370892505596,83.76000213623047,93.16000366210938,65.42553752728116,-34.57446247271883,-0.793070282645715,-0.5380235470413842,-0.0003335421223322754,605583400.0,1.0
403,2023-05-03,AMD,83.54000091552734,85.4800033569336,81.0199966430664,81.62000274658203,109482200.0,0.0,0.0,-8.290000915527344,8.290000915527344,0.0,26.229029537817965,81.0199966430664,92.97000122070312,5.0209696541746816,-94.97903034582532,-1.3361742629160602,-0.6976536913715636,-0.0942181534376133,496101200.0,-1.0
404,2023-05-04,AMD,81.56999969482422,91.63999938964844,81.11000061035156,86.61000061035156,122840500.0,0.0,0.0,4.989997863769531,0.0,4.989997863769531,45.45146123261478,81.0199966430664,92.16000366210938,50.179537209711654,-49.82046279028835,-1.3489159976549985,-0.827906153382361,-0.020581247184703333,618941700.0,1.0
405,2023-05-05,AMD,84.98999786376953,90.43000030517578,84.72000122070312,89.83999633789062,78407400.0,0.0,0.0,3.2299957275390625,0.0,3.2299957275390625,54.337907754347455,81.0199966430664,92.16000366210938,79.17409459210502,-20.82590540789498,-1.0861794527914412,-0.8795608135034251,0.025922081203348046,697349100.0,1.0
406,2023-05-08,AMD,89.98999786376953,95.66000366210938,89.16999816894531,95.04000091552734,95503200.0,0.0,0.0,5.200004577636719,0.0,5.200004577636719,64.9459060537646,81.0199966430664,95.66000366210938,95.76501059203343,-4.234989407966564,-0.4536156471245647,-0.794371779911998,0.1341288479050211,792852300.0,1.0
407,2023-05-09,AMD,94.88999938964844,96.16000366210938,93.43000030517578,95.05999755859376,68674800.0,0.0,0.0,0.01999664306642046,0.0,0.01999664306642046,64.98200297911092,81.0199966430664,96.16000366210938,92.73444125797278,-7.265558742027217,0.048739650126805145,-0.6257494934043942,0.10612048938915852,861527100.0,1.0
408,2023-05-10,AMD,96.41999816894533,99.94000244140624,96.12000274658205,97.0199966430664,95619500.0,0.0,0.0,1.959999084472642,0.0,1.959999084472642,68.63480502343208,81.0199966430664,99.94000244140624,84.56657027771075,-15.433429722289254,0.5979615158399554,-0.3810072909751373,0.10956077234878547,957146600.0,1.0
409,2023-05-11,AMD,98.16000366210938,99.19000244140624,96.13999938964844,97.0999984741211,57061000.0,0.0,0.0,0.0800018310546875,0.0,0.0800018310546875,68.78814183407276,81.0199966430664,99.94000244140624,84.98941280697522,-15.010587193024769,1.0278191228601372,-0.09924200767353494,0.08649429886959137,1014207600.0,1.0
410,2023-05-12,AMD,96.83000183105467,97.4499969482422,93.68000030517578,95.26000213623048,53790400.0,0.0,0.0,-1.8399963378906108,1.8399963378906108,0.0,60.888640932506306,81.0199966430664,99.94000244140624,75.26427658079044,-24.735723419209567,1.206227349977027,0.1618518642528422,0.062102793435233394,960417200.0,-1.0
411,2023-05-15,AMD,95.1999969482422,97.43000030517578,93.4499969482422,97.4000015258789,51749200.0,0.0,0.0,2.1399993896484233,0.0,2.1399993896484233,66.1112364970975,81.0199966430664,99.94000244140624,86.57505212947552,-13.424947870524473,1.5028352996164642,0.4300485516512024,0.08330550059721586,1012166400.0,1.0
412,2023-05-16,AMD,97.38999938964844,103.27999877929688,97.30999755859376,101.4800033569336,90622900.0,0.0,0.0,4.0800018310546875,0.0,4.0800018310546875,73.80578978934993,81.0199966430664,103.27999877929688,91.91376797114678,-8.08623202885323,2.043324605556947,0.7527037627457573,0.2433227143107788,1102789300.0,1.0
413,2023-05-17,AMD,101.79000091552734,104.13999938964844,100.0500030517578,103.75,75240900.0,0.0,0.0,2.2699966430664062,0.0,2.2699966430664062,77.13814921835339,81.0199966430664,104.13999938964844,98.31315162924842,-1.6868483707515713,2.6244539133458886,1.1270537931566786,0.19789861758296623,1178030200.0,1.0
414,2023-05-18,AMD,103.9800033569336,108.0999984741211,103.93000030517578,107.93000030517578,74338700.0,0.0,0.0,4.180000305175781,0.0,4.180000305175781,82.00278949865167,81.0199966430664,108.0999984741211,99.37223723245704,-0.6277627675429576,3.383080085232635,1.5782590518523634,0.2013580220912763,1252368900.0,1.0
415,2023-05-19,AMD,106.36000061035156,107.29000091552734,104.62000274658205,105.81999969482422,67830600.0,0.0,0.0,-2.1100006103515625,2.1100006103515625,0.0,72.96044601561074,81.0199966430664,108.0999984741211,91.58050729272024,-8.41949270727976,3.7706611927676192,2.016739480253481,0.11342591198918717,1184538300.0,-1.0
416,2023-05-22,AMD,104.68000030517578,108.79000091552734,103.48999786376952,108.0,65424200.0,0.0,0.0,2.1800003051757812,0.0,2.1800003051757812,76.10194427719887,81.0199966430664,108.79000091552734,97.15520059782354,-2.8447994021764513,4.205155943814091,2.454422773139739,0.13612458209280076,1249962500.0,1.0
417,2023-05-23,AMD,107.25,110.98999786376952,107.19000244140624,108.12000274658205,73099100.0,0.0,0.0,0.12000274658204546,0.0,0.12000274658204546,76.27700525552538,81.11000061035156,110.98999786376952,90.39492844377965,-9.605071556220356,4.507212181705299,2.864980654983526,0.11440946699217291,1323061600.0,1.0
418,2023-05-24,AMD,105.9800033569336,108.91000366210938,105.63999938964844,108.2699966430664,65910500.0,0.0,0.0,0.1499938964843608,0.0,0.1499938964843608,76.52501142191511,84.72000122070312,110.98999786376952,89.64597804232677,-10.354021957673215,4.7044563388298,3.2328757918464577,0.11503602826443204,1388972100.0,1.0
419,2023-05-25,AMD,117.30999755859376,120.69000244140624,115.8000030517578,120.3499984741211,108514700.0,0.0,0.0,12.080001831054688,0.0,12.080001831054688,88.09271342541466,89.16999816894531,120.69000244140624,98.92130735660399,-1.0786926433960038,5.768615797420708,3.740023793064615,0.2633843772332656,1497486800.0,1.0
420,2023-05-26,AMD,122.45999908447266,127.43000030517578,120.88999938964844,127.02999877929688,92922800.0,0.0,0.0,6.680000305175781,0.0,6.680000305175781,90.94097838683118,93.43000030517578,127.43000030517578,98.82352492388557,-1.17647507611443,7.069280516053439,4.405875137770889,0.304209412620444,1590409600.0,1.0
421,2023-05-30,AMD,130.4199981689453,130.7899932861328,123.51000213623048,125.2699966430664,98902300.0,0.0,0.0,-1.7600021362304688,1.7600021362304688,0.0,84.77608517197932,93.4499969482422,130.7899932861328,85.21693308934523,-14.78306691065476,7.867400454258416,5.09818020115865,0.23443035572689874,1491507300.0,-1.0
422,2023-05-31,AMD,122.41999816894533,123.95999908447266,117.86000061035156,118.20999908447266,87552200.0,0.0,0.0,-7.05999755859375,7.05999755859375,0.0,64.5290843167898,93.4499969482422,130.7899932861328,66.30959979796607,-33.69040020203392,7.8400415536981,5.646552471723733,0.13937348515154357,1403955100.0,-1.0
423,2023-06-01,AMD,117.29000091552734,121.27999877929688,116.5999984741211,119.47000122070312,66032900.0,0.0,0.0,1.2600021362304688,0.0,1.2600021362304688,66.19182202799297,93.4499969482422,130.7899932861328,69.68400327896451,-30.315996721035482,7.82973868854458,6.083189715124334,0.10692116077918645,1469988000.0,1.0
424,2023-06-02,AMD,120.75,121.66000366210938,117.68000030517578,117.86000061035156,52331100.0,0.0,0.0,-1.6100006103515625,1.6100006103515625,0.0,61.91289274750667,93.4499969482422,130.7899932861328,65.37227117330863,-34.627728826691374,7.604038514810938,6.387359475081959,0.11377812275798216,1417656900.0,-1.0
425,2023-06-05,AMD,116.58999633789062,119.31999969482422,116.41999816894533,117.93000030517578,52602900.0,0.0,0.0,0.06999969482421875,0.0,0.06999969482421875,62.03601048626189,97.30999755859376,130.7899932861328,61.589024426371076,-38.410975573628924,7.346131581135481,6.5791138963029026,0.09194444727014606,1470259800.0,1.0
426,2023-06-06,AMD,117.91000366210938,124.41999816894533,117.73999786376952,124.2300033569336,75257500.0,0.0,0.0,6.3000030517578125,0.0,6.3000030517578125,71.57719174961534,100.0500030517578,130.7899932861328,78.6597527221609,-21.3402472778391,7.5627889825527035,6.775848913561268,0.14900111173795572,1545517300.0,1.0
427,2023-06-07,AMD,124.02999877929688,125.33999633789062,117.06999969482422,117.83000183105467,81755200.0,0.0,0.0,-6.4000015258789205,6.4000015258789205,0.0,55.2894812485983,103.48999786376952,130.7899932861328,52.52749586741058,-47.47250413258943,7.135920490647422,6.84786322898096,0.08829782473813808,1463762100.0,-1.0
428,2023-06-08,AMD,118.3000030517578,122.20999908447266,117.0500030517578,121.0500030517578,65246900.0,0.0,0.0,3.220001220703125,0.0,3.220001220703125,60.506632400913574,103.48999786376952,130.7899932861328,64.32237411147578,-35.677625888524226,6.97696840437672,6.8736842640608184,0.005816407033750304,1529009000.0,1.0
429,2023-06-09,AMD,123.56999969482422,127.25,123.5500030517578,124.91999816894533,75051600.0,0.0,0.0,3.8699951171875284,0.0,3.8699951171875284,66.00725920441928,103.48999786376952,130.7899932861328,78.4981827785254,-21.50181722147459,7.081578658928251,6.915263143035215,-0.01661025451175102,1604060600.0,1.0
430,2023-06-12,AMD,128.52000427246094,130.47999572753906,126.4000015258789,129.19000244140625,85394700.0,0.0,0.0,4.270004272460923,0.0,4.270004272460923,71.12697746400886,105.63999938964844,130.7899932861328,93.6382058329238,-6.361794167076197,7.42339938305669,7.016890391041288,0.03129245552316218,1689455300.0,1.0
431,2023-06-13,AMD,132.32000732421875,132.8300018310547,122.4499969482422,124.52999877929688,132461900.0,0.0,0.0,-4.660003662109375,4.660003662109375,0.0,59.78787120692067,105.63999938964844,132.8300018310547,69.47406286687873,-30.52593713312128,7.234931739830998,7.060498660799841,0.05346417176019069,1556993400.0,-1.0
432,2023-06-14,AMD,126.52999877929688,127.7300033569336,123.80999755859376,127.33000183105467,95888100.0,0.0,0.0,2.8000030517577983,0.0,2.8000030517577983,63.79001733388222,115.8000030517578,132.8300018310547,67.70404935855731,-32.29595064144268,7.228148149808504,7.094028558601949,0.06579057947636047,1652881500.0,1.0
433,2023-06-15,AMD,125.38999938964844,125.6999969482422,122.26000213623048,124.23999786376952,85587100.0,0.0,0.0,-3.0900039672851562,3.0900039672851562,0.0,56.61510450295468,116.41999816894533,132.8300018310547,47.653857097427355,-52.346142902572645,6.89399877940609,7.054022602762419,0.054131997457817826,1567294400.0,-1.0
434,2023-06-16,AMD,125.81999969482422,125.8499984741211,119.9000015258789,120.08000183105467,81846900.0,0.0,0.0,-4.159996032714844,4.159996032714844,0.0,48.19450158209627,116.41999816894533,132.8300018310547,22.30349083078075,-77.69650916921925,6.221828129918094,6.887583708192362,0.01823116696612548,1485447500.0,-1.0
435,2023-06-20,AMD,119.08999633789062,121.75,117.6999969482422,118.93000030517578,58851800.0,0.0,0.0,-1.150001525878892,1.150001525878892,0.0,46.01161217906143,116.41999816894533,132.8300018310547,15.29556109744229,-84.70443890255771,5.53256739312323,6.616580445176982,-0.042662826278206056,1426595700.0,-1.0
436,2023-06-21,AMD,118.48999786376952,119.19000244140624,111.66999816894533,112.11000061035156,82835600.0,0.0,0.0,-6.819999694824219,6.819999694824219,0.0,35.125159489134816,111.66999816894533,132.8300018310547,2.079406263025068,-97.92059373697494,4.385515240867221,6.170367404312984,-0.048544522887341346,1343760100.0,-1.0
437,2023-06-22,AMD,112.23999786376952,114.0,109.8499984741211,110.6999969482422,70754800.0,0.0,0.0,-1.4100036621093608,1.4100036621093608,0.0,33.24854372893087,109.8499984741211,132.8300018310547,3.6988614010129983,-96.301138598987,3.324383611582846,5.601170645764868,-0.08550190700193705,1273005300.0,-1.0
438,2023-06-23,AMD,109.30999755859376,111.0999984741211,107.45999908447266,110.01000213623048,73545600.0,0.0,0.0,-0.6899948120117188,0.6899948120117188,0.0,32.274910053676265,107.45999908447266,132.8300018310547,10.051252564808554,-89.94874743519145,2.4000914832188016,4.9609548132537755,-0.11935635807927358,1199459700.0,-1.0
439,2023-06-26,AMD,110.9499969482422,112.5500030517578,107.1999969482422,107.51000213623048,68557000.0,0.0,0.0,-2.5,2.5,0.0,28.754661650555448,107.1999969482422,132.8300018310547,1.2095401050671322,-98.79045989493287,1.4491678288730725,4.258597416375985,-0.16781484554123038,1130902700.0,-1.0
440,2023-06-27,AMD,108.56999969482422,110.97000122070312,107.08000183105467,110.38999938964844,59381600.0,0.0,0.0,2.8799972534179545,0.0,2.8799972534179545,37.775912835877826,107.08000183105467,132.8300018310547,12.85435945084956,-87.14564054915044,0.917352133922293,3.590348359883991,-0.11354693269296978,1190284300.0,1.0
441,2023-06-28,AMD,108.20999908447266,111.77999877929688,107.62999725341795,110.16999816894533,67534100.0,0.0,0.0,-0.2200012207031108,0.2200012207031108,0.0,37.35896086249651,107.08000183105467,132.8300018310547,11.999985778216123,-88.00001422178387,0.4726849578264165,2.966815679471539,-0.13476795268469222,1122750200.0,-1.0
442,2023-06-29,AMD,112.06999969482422,112.76000213623048,109.83999633789062,111.23999786376952,58347200.0,0.0,0.0,1.0699996948241903,0.0,1.0699996948241903,41.012688248291646,107.08000183105467,132.8300018310547,16.15532439889259,-83.84467560110741,0.20426249822061493,2.41430504322069,-0.10463618982233591,1181097400.0,1.0
443,2023-06-30,AMD,113.02999877929688,114.69000244140624,112.41000366210938,113.91000366210938,53331900.0,0.0,0.0,2.670005798339858,0.0,2.670005798339858,49.494561701854906,107.08000183105467,132.8300018310547,26.524278955552226,-73.47572104444777,0.20461011733785028,1.9723660580436968,-0.0513823956933821,1234429300.0,1.0
444,2023-07-03,AMD,115.16000366210938,116.7300033569336,114.51000213623048,115.81999969482422,31860000.0,0.0,0.0,1.9099960327148438,0.0,1.9099960327148438,54.85291192560193,107.08000183105467,132.8300018310547,33.94173927677491,-66.05826072322508,0.3549056697594182,1.6488739803865922,-0.026149841102928284,1266289300.0,1.0
445,2023-07-05,AMD,116.0999984741211,117.66000366210938,113.86000061035156,113.9499969482422,49501600.0,0.0,0.0,-1.870002746582017,1.870002746582017,0.0,48.982222276600595,107.08000183105467,127.7300033569336,33.26873902928258,-66.73126097071741,0.3194484667772599,1.3829888776645618,0.01641241930134063,1216787700.0,-1.0
446,2023-07-06,AMD,112.06999969482422,113.79000091552734,110.30999755859376,113.4800033569336,42342000.0,0.0,0.0,-0.46999359130860796,0.46999359130860796,0.0,47.507700986755175,107.08000183105467,125.8499984741211,34.09697746665854,-65.90302253334147,0.2505377713820991,1.1564986564079578,0.025112976380579077,1174445700.0,-1.0
447,2023-07-07,AMD,114.16000366210938,115.33000183105467,113.04000091552734,113.16999816894533,37135100.0,0.0,0.0,-0.31000518798826704,0.31000518798826704,0.0,46.443646646627414,107.08000183105467,125.8499984741211,32.44537787458944,-67.55462212541056,0.16896424218512607,0.9589917735633137,0.028724624773678986,1137310600.0,-1.0
448,2023-07-10,AMD,113.0,113.61000061035156,109.87999725341795,113.58000183105467,49330200.0,0.0,0.0,0.4100036621093466,0.0,0.4100036621093466,48.213680293214274,107.08000183105467,121.75,44.30811732314828,-55.69188267685172,0.1358332256033492,0.7943600639712688,0.05645986023823757,1186640800.0,1.0
449,2023-07-11,AMD,111.66000366210938,113.2699966430664,109.5,111.31999969482422,59899500.0,0.0,0.0,-2.2600021362304545,2.2600021362304545,0.0,39.83932287555244,107.08000183105467,119.19000244140624,35.01236705260954,-64.98763294739045,-0.07194958454847722,0.621098134267276,0.008424678959306098,1126741300.0,-1.0
450,2023-07-12,AMD,112.88999938964844,115.4000015258789,112.30999755859376,114.58000183105467,57993100.0,0.0,0.0,3.2600021362304545,0.0,3.2600021362304545,53.331017024819616,107.08000183105467,117.66000366210938,70.88845654058208,-29.111543459417927,0.026124690460605393,0.5021034455059179,0.04002907992561289,1184734400.0,1.0
451,2023-07-13,AMD,115.76000213623048,116.16000366210938,113.58000183105467,115.91999816894533,49206700.0,0.0,0.0,1.3399963378906534,0.0,1.3399963378906534,57.81762788965991,107.08000183105467,117.66000366210938,83.55382616232883,-16.446173837671164,0.20955620506370565,0.443593997417466,0.04207120096233008,1233941100.0,1.0
452,2023-07-14,AMD,116.16999816894533,122.12000274658205,115.25,115.94000244140624,91847300.0,0.0,0.0,0.02000427246090908,0.0,0.02000427246090908,57.887365896421514,107.08000183105467,122.12000274658205,58.909574940281104,-41.09042505971889,0.35247790366057075,0.4253707786660847,0.01782107553361545,1325788400.0,1.0
453,2023-07-17,AMD,115.9499969482422,118.83999633789062,112.7300033569336,118.31999969482422,68593300.0,0.0,0.0,2.379997253417983,0.0,2.379997253417983,65.6771215589004,107.08000183105467,122.12000274658205,74.73402380025999,-25.26597619974002,0.6502881625453085,0.4703542554419341,0.02158521849928574,1394381700.0,1.0
454,2023-07-18,AMD,117.5500030517578,118.43000030517578,115.19000244140624,117.93000030517578,57980100.0,0.0,0.0,-0.3899993896484375,0.3899993896484375,0.0,63.45774279119394,107.62999725341795,122.12000274658205,71.08349997946536,-28.916500020534635,0.8450943015665189,0.5453022646668572,0.03492763021960732,1336401600.0,-1.0
455,2023-07-19,AMD,121.3000030517578,121.66999816894533,115.5500030517578,116.43000030517578,70363100.0,0.0,0.0,-1.5,1.5,0.0,55.182281574961216,109.5,122.12000274658205,54.912827234151564,-45.08717276584843,0.8684344391293877,0.6099286995593675,0.025995742518295728,1266038500.0,-1.0
456,2023-07-20,AMD,114.95999908447266,115.0500030517578,109.23999786376952,110.25,76340400.0,0.0,0.0,-6.180000305175781,6.180000305175781,0.0,34.064306181355875,109.23999786376952,122.12000274658205,7.841628519708566,-92.15837148029144,0.3838447274904553,0.5647119051455826,-0.025801875198285473,1189698100.0,-1.0
457,2023-07-21,AMD,110.97000122070312,112.3000030517578,109.54000091552734,110.9499969482422,76778100.0,0.0,0.0,0.6999969482422017,0.0,0.6999969482422017,37.20505267716785,109.23999786376952,122.12000274658205,13.276385374314255,-86.72361462568574,0.05564516750774828,0.4628985576180114,-0.02315552773739593,1266476200.0,1.0
458,2023-07-24,AMD,110.62000274658205,111.30999755859376,108.5500030517578,110.61000061035156,45583600.0,0.0,0.0,-0.3399963378906392,0.3399963378906392,0.0,36.237669430924704,108.5500030517578,122.12000274658205,15.180527670752056,-84.81947232924794,-0.22924695044059717,0.324469456006285,-0.0063780011356365796,1220892600.0,-1.0
459,2023-07-25,AMD,111.13999938964844,114.0500030517578,111.0,113.0,44916300.0,0.0,0.0,2.3899993896484375,0.0,2.3899993896484375,47.34284621431078,108.5500030517578,122.12000274658205,32.792903819588744,-67.20709618041126,-0.2591889427009164,0.2077377762648416,-0.013789507818164903,1265808900.0,1.0
460,2023-07-26,AMD,111.91000366210938,112.36000061035156,109.3000030517578,110.08999633789062,51721700.0,0.0,0.0,-2.910003662109375,2.910003662109375,0.0,38.03604739505762,108.5500030517578,122.12000274658205,11.348513786040819,-88.65148621395919,-0.5118269019682202,0.06382484061822619,-0.05029332231836203,1214087200.0,-1.0
461,2023-07-27,AMD,111.79000091552734,115.08000183105467,110.51000213623048,111.0999984741211,70678000.0,0.0,0.0,1.0100021362304688,0.0,1.0100021362304688,42.55825263039671,108.5500030517578,122.12000274658205,18.79141842085592,-81.20858157914408,-0.6233611522033584,-0.07361235794609308,-0.04174576388965645,1284765200.0,1.0
462,2023-07-28,AMD,113.37999725341795,114.86000061035156,112.44000244140624,112.95999908447266,55526000.0,0.0,0.0,1.8600006103515625,0.0,1.8600006103515625,50.27023861872058,108.5500030517578,122.12000274658205,32.49812919595629,-67.5018708040437,-0.5552678416719914,-0.16994345469127403,-0.04530088424760226,1340291200.0,1.0
463,2023-07-31,AMD,114.16000366210938,114.68000030517578,112.3499984741211,114.4000015258789,54187300.0,0.0,0.0,1.44000244140625,0.0,1.44000244140625,55.59574846268946,108.5500030517578,122.12000274658205,43.10979075668192,-56.89020924331808,-0.38072018941794283,-0.21209880163660824,-0.029933000679742583,1394478500.0,1.0
464,2023-08-01,AMD,114.26000213623048,118.19000244140624,113.16000366210938,117.5999984741211,95279300.0,0.0,0.0,3.1999969482421875,0.0,3.1999969482421875,65.16183543819184,108.5500030517578,122.12000274658205,66.69119842217142,-33.308801577828575,0.015639382601165153,-0.16655116478905319,0.010048940701525622,1489757800.0,1.0
465,2023-08-02,AMD,119.48999786376952,119.5,107.37999725341795,109.3499984741211,173372000.0,0.0,0.0,-8.25,8.25,0.0,39.712041300895486,107.37999725341795,122.12000274658205,13.364996516566825,-86.63500348343318,-0.33211236730501525,-0.19966340529224583,-0.00816327914629389,1316385800.0,-1.0
466,2023-08-03,AMD,108.9499969482422,114.95999908447266,108.9499969482422,113.1500015258789,90605400.0,0.0,0.0,3.8000030517578125,0.0,3.8000030517578125,50.07506273372772,107.37999725341795,121.66999816894533,40.377913945347075,-59.622086054652925,-0.29765192868146073,-0.21926110997008888,0.019828793493910535,1406991200.0,1.0
467,2023-08-04,AMD,114.4800033569336,118.8499984741211,113.95999908447266,115.81999969482422,83083100.0,0.0,0.0,2.6699981689453125,0.0,2.6699981689453125,56.18150430523141,107.37999725341795,121.66999816894533,59.062294616338626,-40.937705383661374,-0.054271891691357155,-0.1862632663143424,0.0471024234311872,1490074300.0,1.0
468,2023-08-07,AMD,116.36000061035156,119.08000183105467,115.48999786376952,116.80999755859376,65854800.0,0.0,0.0,0.9899978637695455,0.0,0.9899978637695455,58.36045715009681,107.37999725341795,121.66999816894533,65.99020084686813,-34.00979915313185,0.2160023542799081,-0.10581014219549204,0.03371679255392701,1555929100.0,1.0
469,2023-08-08,AMD,114.94000244140624,115.45999908447266,111.41000366210938,113.2300033569336,54141800.0,0.0,0.0,-3.5799942016601705,3.5799942016601705,0.0,48.332248910838075,107.37999725341795,119.5,48.26736615357118,-51.73263384642882,0.13971307441701697,-0.05670549887299011,0.02852218297297049,1501787300.0,-1.0
470,2023-08-09,AMD,112.88999938964844,113.1500015258789,108.77999877929688,110.47000122070312,56257100.0,0.0,0.0,-2.7600021362304688,2.7600021362304688,0.0,41.92396160059282,107.37999725341795,119.5,25.495076460742393,-74.5049235392576,-0.14181917211955408,-0.07372823352230294,-0.005670542412876012,1445530200.0,-1.0
471,2023-08-10,AMD,111.3000030517578,113.88999938964844,109.47000122070312,110.2300033569336,57297800.0,0.0,0.0,-0.23999786376953125,0.23999786376953125,0.0,41.37356745513154,107.37999725341795,119.5,23.514896515344173,-76.48510348465582,-0.3799216534144989,-0.13496691750074225,-0.02416780939859553,1388232400.0,-1.0
472,2023-08-11,AMD,108.8499984741211,109.06999969482422,106.4800033569336,107.56999969482422,55618700.0,0.0,0.0,-2.660003662109375,2.660003662109375,0.0,35.42580067300037,106.4800033569336,119.5,8.371709822760096,-91.6282901772399,-0.7743320758390837,-0.2628399491684107,-0.05970281241219777,1332613700.0,-1.0
473,2023-08-14,AMD,106.75,111.98999786376952,105.41999816894533,111.9800033569336,57421800.0,0.0,0.0,4.410003662109375,0.0,4.410003662109375,49.35364184212461,105.41999816894533,119.5,46.59093987842816,-53.40906012157184,-0.7227259205642014,-0.35481714344756893,-0.04778907474581495,1390035500.0,1.0
474,2023-08-15,AMD,111.98999786376952,113.18000030517578,110.16999816894533,111.3499984741211,53816600.0,0.0,0.0,-0.6300048828125,0.6300048828125,0.0,47.65920855832892,105.41999816894533,119.5,42.116473963068906,-57.88352603693109,-0.7243140417301959,-0.4287165231040944,0.01828989508832346,1336218900.0,-1.0
475,2023-08-16,AMD,110.08999633789062,110.44000244140624,106.9800033569336,107.19000244140624,54327300.0,0.0,0.0,-4.159996032714858,4.159996032714858,0.0,37.777439588456176,105.41999816894533,119.5,12.57105143663412,-87.42894856336588,-1.0491536506238361,-0.5528039486080428,-0.05267343353158982,1281891600.0,-1.0
476,2023-08-17,AMD,107.62000274658205,107.8499984741211,104.0999984741211,104.44000244140624,59064300.0,0.0,0.0,-2.75,2.75,0.0,32.61871438667454,104.0999984741211,119.5,2.207817750626732,-97.79218224937327,-1.5110734903958445,-0.7444578569656033,-0.09825589089451991,1222827300.0,-1.0
477,2023-08-18,AMD,102.4000015258789,106.06999969482422,101.68000030517578,105.4499969482422,59884300.0,0.0,0.0,1.009994506835966,0.0,1.009994506835966,36.304682756786754,101.68000030517578,119.5,21.155986013632806,-78.84401398636719,-1.7751872808389209,-0.950603741740267,-0.09725195486502092,1282711600.0,1.0
478,2023-08-21,AMD,106.1999969482422,108.54000091552734,105.66999816894533,108.22000122070312,49319200.0,0.0,0.0,2.7700042724609233,0.0,2.7700042724609233,45.70387405494976,101.68000030517578,119.5,36.70034246648653,-63.29965753351347,-1.7409159513326529,-1.1086661836587444,-0.04424624205333194,1332030800.0,1.0
479,2023-08-22,AMD,109.4000015258789,109.72000122070312,104.8499984741211,105.66000366210938,47335100.0,0.0,0.0,-2.55999755859375,2.55999755859375,0.0,39.4898183921999,101.68000030517578,119.08000183105467,22.87358050523251,-77.12641949476749,-1.8984411626631612,-1.2666211794596278,-0.04354121033260483,1284695700.0,-1.0
480,2023-08-23,AMD,105.6500015258789,110.08000183105467,105.0,109.43000030517578,54656300.0,0.0,0.0,3.7699966430664062,0.0,3.7699966430664062,50.8459570926591,101.68000030517578,119.08000183105467,44.54022597913846,-55.45977402086153,-1.6994843619897324,-1.353193815965649,-0.0072575798547999115,1339352000.0,1.0
481,2023-08-24,AMD,111.05999755859376,111.63999938964844,100.87000274658205,101.8000030517578,109179100.0,0.0,0.0,-7.629997253417983,7.629997253417983,0.0,35.35236719921697,100.87000274658205,119.08000183105467,5.107085952402651,-94.89291404759736,-2.1328977536664837,-1.509134603505816,-0.05363945950949045,1230172900.0,-1.0
482,2023-08-25,AMD,101.16999816894533,104.12000274658205,99.58000183105467,102.25,74793100.0,0.0,0.0,0.4499969482422017,0.0,0.4499969482422017,36.66567898669881,99.58000183105467,115.45999908447266,16.81359339259735,-83.18640660740265,-2.412263021738738,-1.6897602871524007,-0.08689054353677272,1304966000.0,1.0
483,2023-08-28,AMD,103.47000122070312,104.06999969482422,100.88999938964844,102.61000061035156,55386800.0,0.0,0.0,0.3600006103515625,0.0,0.3600006103515625,37.83148761680801,99.58000183105467,113.88999938964844,21.17399927491424,-78.82600072508575,-2.5749308352368274,-1.8667943967692864,-0.07849122571654821,1360352800.0,1.0
484,2023-08-29,AMD,102.11000061035156,106.56999969482422,101.79000091552734,105.91999816894533,50850300.0,0.0,0.0,3.309997558593764,0.0,3.309997558593764,47.98838039229216,99.58000183105467,113.88999938964844,44.304664008018754,-55.69533599198125,-2.4089885282988064,-1.9752332230751903,-0.011848159749367815,1411203100.0,1.0
485,2023-08-30,AMD,105.4000015258789,107.66999816894533,104.5,106.58999633789062,54847300.0,0.0,0.0,0.6699981689452983,0.0,0.6699981689452983,49.900086880827416,99.58000183105467,113.18000030517578,51.54408303923702,-48.45591696076298,-2.1980768743618597,-2.019801953332524,0.020585923460606947,1466050400.0,1.0
486,2023-08-31,AMD,106.19000244140624,108.05999755859376,104.86000061035156,105.72000122070312,58919000.0,0.0,0.0,-0.8699951171875,0.8699951171875,0.0,47.295540272149914,99.58000183105467,113.18000030517578,45.14705940101398,-54.852940598986024,-2.07718453831977,-2.0312784703299736,0.0025604957825977603,1407131400.0,-1.0
487,2023-09-01,AMD,107.0,110.05999755859376,106.61000061035156,109.4499969482422,54808900.0,0.0,0.0,3.7299957275390767,0.0,3.7299957275390767,58.11150009983026,99.58000183105467,113.18000030517578,72.57350165125935,-27.42649834874065,-1.6612478494838427,-1.9572723461607473,0.01136569685515565,1461940300.0,1.0
488,2023-09-05,AMD,109.0,111.81999969482422,106.3000030517578,110.77999877929688,66042200.0,0.0,0.0,1.3300018310546733,0.0,1.3300018310546733,61.37288311301256,99.58000183105467,111.81999969482422,91.50325901113307,-8.49674098886693,-1.2103431384221608,-1.8078865046130304,0.04845726802698924,1527982500.0,1.0
489,2023-09-06,AMD,110.55999755859376,111.33000183105467,108.22000122070312,109.27999877929688,47736700.0,0.0,0.0,-1.5,1.5,0.0,55.72667295319748,99.58000183105467,111.81999969482422,79.24835491151711,-20.751645088482892,-0.9629350256085445,-1.638896208812133,-0.0013707532254462196,1480245800.0,-1.0
490,2023-09-07,AMD,106.13999938964844,107.69000244140624,105.08999633789062,106.58999633789062,49080100.0,0.0,0.0,-2.69000244140625,2.69000244140625,0.0,46.814730680463796,99.58000183105467,111.81999969482422,57.27120694673952,-42.72879305326049,-0.9727098490533734,-1.5056589368603812,0.04705297782454365,1431165700.0,-1.0
491,2023-09-08,AMD,107.0199966430664,109.73999786376952,105.75,106.08999633789062,46232000.0,0.0,0.0,-0.5,0.5,0.0,45.26230384241958,99.58000183105467,111.81999969482422,53.18623891353419,-46.81376108646581,-1.0091691446818913,-1.4063609784246833,0.0375549764096883,1384933700.0,-1.0
492,2023-09-11,AMD,107.31999969482422,107.51000213623048,103.0,105.31999969482422,50611300.0,0.0,0.0,-0.7699966430664062,0.7699966430664062,0.0,42.74365838563611,99.58000183105467,111.81999969482422,46.89541556833084,-53.10458443166917,-1.0876577528494664,-1.34262033330964,0.0264106721406574,1334322400.0,-1.0
493,2023-09-12,AMD,104.1999969482422,106.73999786376952,103.18000030517578,105.30999755859376,44413600.0,0.0,0.0,-0.01000213623045454,0.01000213623045454,0.0,42.70803855517143,99.58000183105467,111.81999969482422,46.8136987548005,-53.18630124519951,-1.1375546025502956,-1.3016071871577712,-0.0057590693060491915,1289908800.0,-1.0
494,2023-09-13,AMD,105.0999984741211,108.73999786376952,104.83000183105467,107.70999908447266,44702300.0,0.0,0.0,2.400001525878892,0.0,2.400001525878892,53.44845089104187,99.58000183105467,111.81999969482422,66.42155778051902,-33.578442219480976,-0.9722311257303744,-1.235731974872292,0.01050757843195349,1334611100.0,1.0
495,2023-09-14,AMD,108.43000030517578,109.1500015258789,106.22000122070312,106.62999725341795,45920600.0,0.0,0.0,-1.0800018310547017,1.0800018310547017,0.0,48.70731568838104,99.58000183105467,111.81999969482422,57.59801186919569,-42.40198813080431,-0.9177785154561349,-1.1721412829890605,0.008607605204384194,1288690500.0,-1.0
496,2023-09-15,AMD,106.06999969482422,106.76000213623048,101.27999877929688,101.48999786376952,71017600.0,0.0,0.0,-5.1399993896484375,5.1399993896484375,0.0,32.75283685652546,100.88999938964844,111.81999969482422,5.489464385805706,-94.5105356141943,-1.2746851776010004,-1.1926500619114486,-0.07272726639030325,1217672900.0,-1.0
497,2023-09-18,AMD,100.81999969482422,102.98999786376952,99.4499969482422,102.37000274658205,49061300.0,0.0,0.0,0.8800048828125284,0.0,0.8800048828125284,36.83980992455038,99.4499969482422,111.81999969482422,23.605538803511397,-76.3944611964886,-1.4695868247895163,-1.2480374144870623,-0.07591619539073813,1266734200.0,1.0
498,2023-09-19,AMD,101.75,102.86000061035156,100.6999969482422,101.61000061035156,41704100.0,0.0,0.0,-0.760002136230483,0.760002136230483,0.0,34.7360970487148,99.4499969482422,111.81999969482422,17.461626374385375,-82.53837362561462,-1.6661670052305624,-1.3316633326357625,-0.07018666045591493,1225030100.0,-1.0
499,2023-09-20,AMD,102.36000061035156,103.94000244140624,100.27999877929688,100.33999633789062,55180600.0,0.0,0.0,-1.2700042724609375,1.2700042724609375,0.0,31.290818904518616,99.4499969482422,111.81999969482422,7.194819660766373,-92.80518033923363,-1.902505944891061,-1.4458318550868223,-0.058635896563759005,1169849500.0,-1.0
500,2023-09-21,AMD,98.5999984741211,98.87000274658205,95.83999633789062,96.11000061035156,59628600.0,0.0,0.0,-4.2299957275390625,4.2299957275390625,0.0,22.655194886004992,95.83999633789062,111.81999969482422,1.689638396376086,-98.31036160362392,-2.4034260736108877,-1.6373506987916355,-0.09407103470673461,1110220900.0,-1.0
501,2023-09-22,AMD,96.91999816894533,98.41999816894533,95.61000061035156,96.1999969482422,52169400.0,0.0,0.0,0.08999633789063921,0.0,0.08999633789063921,23.175680028376348,95.61000061035156,111.81999969482422,3.6397061765153884,-96.36029382348461,-2.7613161961026407,-1.8621437982538367,-0.08659326597994854,1162390300.0,1.0
502,2023-09-25,AMD,95.9499969482422,97.4499969482422,94.45999908447266,97.37999725341795,43223700.0,0.0,0.0,1.1800003051757528,0.0,1.1800003051757528,30.274319766429656,94.45999908447266,111.33000183105467,17.3088185746556,-82.6911814253444,-2.91611543149952,-2.0729381249029735,-0.07530149548017617,1205614000.0,1.0
503,2023-09-26,AMD,96.5,97.83000183105467,95.2699966430664,95.95999908447266,42866500.0,0.0,0.0,-1.4199981689452983,1.4199981689452983,0.0,26.831776477305084,94.45999908447266,109.73999786376952,9.816754710951786,-90.1832452890482,-3.11744092718007,-2.2818386853583927,-0.10908922198379134,1162747500.0,-1.0
504,2023-09-27,AMD,96.81999969482422,99.2300033569336,96.3499984741211,98.06999969482422,51261500.0,0.0,0.0,2.1100006103515625,0.0,2.1100006103515625,38.769362191718635,94.45999908447266,109.73999786376952,23.62566033213835,-76.37433966786165,-3.071329145982105,-2.4397367774831356,-0.08027757459516727,1214009000.0,1.0
505,2023-09-28,AMD,97.94000244140624,104.1999969482422,97.76000213623048,102.76000213623048,72542100.0,0.0,0.0,4.690002441406264,0.0,4.690002441406264,56.83238532595611,94.45999908447266,109.1500015258789,56.50103248698495,-43.49896751301506,-2.626069739166482,-2.477003369819805,0.012513590493574478,1286551100.0,1.0
506,2023-09-29,AMD,104.69000244140624,104.94000244140624,102.55999755859376,102.81999969482422,56027300.0,0.0,0.0,0.05999755859373579,0.0,0.05999755859373579,57.019540194300745,94.45999908447266,109.1500015258789,56.90945691600084,-43.09054308399915,-2.2425069281831043,-2.430104081492465,0.0043957891586283715,1342578400.0,1.0
507,2023-10-02,AMD,102.20999908447266,103.70999908447266,101.6999969482422,103.2699966430664,45118600.0,0.0,0.0,0.4499969482421875,0.0,0.4499969482421875,58.57386366185218,94.45999908447266,109.1500015258789,59.972744005550915,-40.027255994449085,-1.8805419446012337,-2.3201916541142187,0.016336935564841726,1387697000.0,1.0
508,2023-10-03,AMD,101.8000030517578,103.29000091552734,99.16999816894533,100.08000183105467,48117000.0,0.0,0.0,-3.189994812011733,3.189994812011733,0.0,45.202846510522875,94.45999908447266,109.1500015258789,38.2573302421046,-61.742669757895406,-1.829992874916499,-2.222151898274675,-0.00259113530321875,1339580000.0,-1.0
509,2023-10-04,AMD,100.6500015258789,104.4000015258789,100.33999633789062,104.06999969482422,51023200.0,0.0,0.0,3.9899978637695455,0.0,3.9899978637695455,58.78212664132915,94.45999908447266,106.76000213623048,78.13006687813927,-21.86993312186072,-1.4512439860739192,-2.0679703158345237,0.08282175667383496,1390603200.0,1.0
510,2023-10-05,AMD,103.41000366210938,103.73999786376952,100.2699966430664,102.91000366210938,51789700.0,0.0,0.0,-1.1599960327148438,1.1599960327148438,0.0,54.27068063220071,94.45999908447266,104.94000244140624,80.62978884492617,-19.37021115507384,-1.230500271654691,-1.900476306998557,0.0697505917539405,1338813500.0,-1.0
511,2023-10-06,AMD,102.16000366210938,107.87000274658205,102.02999877929688,107.23999786376952,64807500.0,0.0,0.0,4.329994201660142,0.0,4.329994201660142,65.63150218194998,94.45999908447266,107.87000274658205,95.30197829406536,-4.698021705934634,-0.6981176017411741,-1.6600045659470808,0.10125283311204325,1403621000.0,1.0
512,2023-10-09,AMD,106.01000213623048,107.30999755859376,104.79000091552734,106.97000122070312,39593200.0,0.0,0.0,-0.26999664306639204,0.26999664306639204,0.0,64.47897263941147,94.45999908447266,107.87000274658205,93.2885810581699,-6.7114189418301065,-0.29459110420502554,-1.38692187359867,0.11473532973399125,1364027800.0,-1.0
513,2023-10-10,AMD,107.48999786376952,110.12000274658205,106.4000015258789,109.01000213623048,57105500.0,0.0,0.0,2.040000915527358,0.0,2.040000915527358,69.19504259933989,94.45999908447266,110.12000274658205,92.91187515468278,-7.088124845317223,0.18765436331024432,-1.072006626216887,0.11155299760833626,1421133300.0,1.0
514,2023-10-11,AMD,109.13999938964844,110.0999984741211,106.93000030517578,108.30999755859376,51085600.0,0.0,0.0,-0.7000045776367188,0.7000045776367188,0.0,65.73932393449061,94.45999908447266,110.12000274658205,88.44185973999654,-11.558140260003459,0.5075026907851452,-0.7561047628164805,0.05400929648683306,1370047700.0,-1.0
515,2023-10-12,AMD,108.4000015258789,111.30999755859376,107.51000213623048,108.79000091552734,60959400.0,0.0,0.0,0.48000335693357954,0.0,0.48000335693357954,67.04165123330979,94.45999908447266,111.30999755859376,85.04452895389439,-14.955471046105618,0.7906034582830443,-0.4467631185965755,0.058062645773414134,1431007100.0,1.0
516,2023-10-13,AMD,108.6500015258789,108.97000122070312,104.75,105.08999633789062,52881500.0,0.0,0.0,-3.7000045776367188,3.7000045776367188,0.0,50.10256237120244,95.2699966430664,111.30999755859376,61.221939740153445,-38.77806025984656,0.7082393378508982,-0.21576262730708073,0.01762370246911793,1378125600.0,-1.0
517,2023-10-16,AMD,105.41999816894533,107.4800033569336,105.02999877929688,106.45999908447266,42464500.0,0.0,0.0,1.3700027465820312,0.0,1.3700027465820312,54.96407597067009,96.3499984741211,111.30999755859376,67.58022211943158,-32.41977788056841,0.7449258843203665,-0.02362492498159122,0.06374897218914999,1420590100.0,1.0
518,2023-10-17,AMD,103.54000091552734,106.29000091552734,101.66000366210938,105.13999938964844,49642100.0,0.0,0.0,-1.3199996948242188,1.3199996948242188,0.0,49.592412503172596,97.76000213623048,111.30999755859376,54.46494277952157,-45.53505722047842,0.6598806216953079,0.11307618435378865,0.010281538368039689,1370948000.0,-1.0
519,2023-10-18,AMD,103.37999725341795,104.77999877929688,101.73999786376952,102.16999816894533,50450000.0,0.0,0.0,-2.970001220703111,2.970001220703111,0.0,39.556102588353156,99.16999816894533,111.30999755859376,24.711698112258944,-75.28830188774106,0.34880658193918634,0.16022226387086821,-0.0071908023207709615,1320498000.0,-1.0
520,2023-10-19,AMD,103.80999755859376,105.5999984741211,101.83999633789062,102.4000015258789,52734200.0,0.0,0.0,0.23000335693357954,0.0,0.23000335693357954,40.6297293057922,99.16999816894533,111.30999755859376,26.60628928604186,-73.39371071395814,0.11946044446636961,0.1520698999899685,-0.045132380028942376,1373232200.0,1.0
521,2023-10-20,AMD,102.27999877929688,104.33999633789062,101.44000244140624,101.80999755859376,61285600.0,0.0,0.0,-0.590003967285142,0.590003967285142,0.0,38.60036096615027,99.16999816894533,111.30999755859376,21.746289311180018,-78.25371068881998,-0.10865390831551736,0.09992513832887133,-0.048237857373331416,1311946600.0,-1.0
522,2023-10-23,AMD,100.80999755859376,102.41999816894533,99.31999969482422,100.01000213623048,50817400.0,0.0,0.0,-1.7999954223632812,1.7999954223632812,0.0,32.82831343746034,99.31999969482422,111.30999755859376,5.754817050395485,-94.24518294960451,-0.42972711456883417,-0.0060053122506697944,-0.08256123129648818,1261129200.0,-1.0
523,2023-10-24,AMD,100.97000122070312,101.79000091552734,99.37999725341795,101.66999816894533,51982900.0,0.0,0.0,1.6599960327148438,0.0,1.6599960327148438,42.049362022396096,99.31999969482422,111.30999755859376,19.59965715441996,-80.40034284558004,-0.5439617034557074,-0.11359659049167736,-0.0613055077030753,1313112100.0,1.0
524,2023-10-25,AMD,100.41999816894533,101.02999877929688,95.2300033569336,96.05999755859376,53424500.0,0.0,0.0,-5.6100006103515625,5.6100006103515625,0.0,27.388355675033964,95.2300033569336,111.30999755859376,5.161657344220175,-94.83834265577983,-1.0747841011915682,-0.3058340926316556,-0.11701446134574534,1259687600.0,-1.0
525,2023-10-26,AMD,95.98999786376952,97.5199966430664,93.12000274658205,93.66999816894533,49896400.0,0.0,0.0,-2.3899993896484375,2.3899993896484375,0.0,23.381060254164623,93.12000274658205,111.30999755859376,3.023615058977879,-96.97638494102212,-1.6690775412920544,-0.5784827823637355,-0.1086687464735192,1209791200.0,-1.0
526,2023-10-27,AMD,95.8000030517578,97.3499984741211,94.58999633789062,96.43000030517578,52458700.0,0.0,0.0,2.7600021362304545,0.0,2.7600021362304545,35.881572230165915,93.12000274658205,111.30999755859376,18.196803203088255,-81.80319679691175,-1.8955001462502992,-0.8418862551410483,-0.0942137785605125,1262249900.0,1.0
527,2023-10-30,AMD,96.13999938964844,97.04000091552734,94.6999969482422,96.18000030517578,43716600.0,0.0,0.0,-0.25,0.25,0.0,35.27998507808603,93.12000274658205,111.30999755859376,16.82242128278714,-83.17757871721287,-2.0712386500690485,-1.0877567341266485,-0.08521969884427083,1218533300.0,-1.0
528,2023-10-31,AMD,96.23999786376952,98.81999969482422,94.06999969482422,98.5,79547100.0,0.0,0.0,2.3199996948242188,0.0,2.3199996948242188,45.13040353635259,93.12000274658205,111.30999755859376,29.576683825469193,-70.42331617453081,-2.0002504692726006,-1.270255481155839,-0.03592050733794405,1298080400.0,1.0
529,2023-11-01,AMD,98.58000183105467,108.1500015258789,98.5,108.04000091552734,138641500.0,0.0,0.0,9.540000915527344,0.0,9.540000915527344,68.13880748957651,93.12000274658205,108.97000122070312,94.13248962330042,-5.867510376699592,-1.1608124248812857,-1.2483668699009285,0.05507811821880759,1436721900.0,1.0
530,2023-11-02,AMD,107.95999908447266,109.41000366210938,105.91000366210938,107.83000183105467,71377000.0,0.0,0.0,-0.20999908447267046,0.20999908447267046,0.0,67.42074021346676,93.12000274658205,109.41000366210938,90.30078734035753,-9.699212659642473,-0.5066564766183603,-1.100024791244415,0.059129794880864006,1365344900.0,-1.0
531,2023-11-03,AMD,109.0500030517578,113.38999938964844,107.86000061035156,112.25,65576600.0,0.0,0.0,4.419998168945327,0.0,4.419998168945327,74.05967757966351,93.12000274658205,113.38999938964844,94.3759270920334,-5.624072907966606,0.3642251496624169,-0.8071748030630486,0.12238773724948615,1430921500.0,1.0
532,2023-11-06,AMD,112.5999984741211,113.08000183105467,110.22000122070312,111.75,49270400.0,0.0,0.0,-0.5,0.5,0.0,72.1408565273008,93.12000274658205,113.38999938964844,91.90922712752683,-8.090772872473167,1.0025030624235995,-0.4452392299657189,0.09914431014648684,1381651100.0,-1.0
533,2023-11-07,AMD,111.86000061035156,114.6500015258789,111.22000122070312,113.4499969482422,50550200.0,0.0,0.0,1.6999969482422017,0.0,1.6999969482422017,74.71128468089972,93.12000274658205,114.6500015258789,94.42636021516813,-5.573639784831864,1.6267660966350945,-0.0308381646455561,0.18103268615055979,1432201300.0,1.0
534,2023-11-08,AMD,113.5500030517578,115.31999969482422,112.87999725341795,113.58999633789062,41880600.0,0.0,0.0,0.1399993896484233,0.0,0.1399993896484233,74.93107036856881,93.12000274658205,115.31999969482422,92.207191014634,-7.792808985365999,2.10849046271764,0.39702756082708324,0.21266145573118456,1474081900.0,1.0
535,2023-11-09,AMD,114.0999984741211,115.80999755859376,113.05999755859376,113.48999786376952,61146900.0,0.0,0.0,-0.09999847412110796,0.09999847412110796,0.0,74.39816511374804,93.12000274658205,115.80999755859376,89.77523038658397,-10.224769613416026,2.453904370208903,0.8084029227034474,0.17691587166445388,1412935000.0,-1.0
536,2023-11-10,AMD,114.3499984741211,119.6999969482422,114.02999877929688,118.58999633789062,75135900.0,0.0,0.0,5.099998474121108,0.0,5.099998474121108,81.95168415794501,93.12000274658205,119.6999969482422,95.82392455795853,-4.176075442041471,3.1034005434319027,1.2674024468491387,0.2330005818424694,1488070900.0,1.0
537,2023-11-13,AMD,118.33999633789062,118.68000030517578,116.0,116.79000091552734,46741900.0,0.0,0.0,-1.7999954223632812,1.7999954223632812,0.0,73.16128091589164,93.12000274658205,119.6999969482422,89.05193127343458,-10.948068726565422,3.433309306530475,1.7005838187854063,0.1856852884825111,1441329000.0,-1.0
538,2023-11-14,AMD,119.6999969482422,122.11000061035156,119.22000122070312,119.87999725341795,61017400.0,0.0,0.0,3.089996337890611,0.0,3.089996337890611,77.86431701420013,93.12000274658205,122.11000061035156,92.30768016123046,-7.692319838769539,3.899154224159105,2.1402978998601463,0.10958900627137069,1502346400.0,1.0
539,2023-11-15,AMD,120.54000091552734,120.58999633789062,116.87000274658205,118.0,59555600.0,0.0,0.0,-1.8799972534179545,1.8799972534179545,0.0,69.33496593589825,94.06999969482422,122.11000061035156,85.34236634751456,-14.657633652485444,4.06972634481221,2.526183588850559,0.09431510707826396,1442790800.0,-1.0
540,2023-11-16,AMD,117.1999969482422,120.7300033569336,116.41000366210938,119.83000183105467,49661900.0,0.0,0.0,1.8300018310546733,0.0,1.8300018310546733,72.69443671940392,94.06999969482422,122.11000061035156,91.86876353476036,-8.131236465239642,4.302969869006034,2.8815408448816546,0.06752785595594357,1492452700.0,1.0
541,2023-11-17,AMD,119.63999938964844,121.48999786376952,118.81999969482422,120.62000274658205,38508900.0,0.0,0.0,0.7900009155273722,0.0,0.7900009155273722,74.10738821661307,94.06999969482422,122.11000061035156,94.68617041683326,-5.313829583166741,4.499693841663159,3.205171444237956,0.07937362636762457,1530961600.0,1.0
542,2023-11-20,AMD,120.6999969482422,121.93000030517578,120.06999969482422,121.52999877929688,43138700.0,0.0,0.0,0.9099960327148295,0.0,0.9099960327148295,75.77358064155992,98.5,122.11000061035156,97.54340611579488,-2.456593884205118,4.67513602137349,3.499164359665063,0.07122082017103004,1574100300.0,1.0
543,2023-11-21,AMD,120.54000091552734,120.6500015258789,117.94000244140624,119.16000366210938,41064800.0,0.0,0.0,-2.3699951171875,2.3699951171875,0.0,63.49508255026985,105.91000366210938,122.11000061035156,81.79013886442563,-18.209861135574364,4.570253383055629,3.7133821643431766,0.04903607275107147,1533035500.0,-1.0
544,2023-11-22,AMD,120.0,124.76000213623048,119.9499969482422,122.51000213623048,56862200.0,0.0,0.0,3.349998474121108,0.0,3.349998474121108,71.12603750172792,107.86000061035156,124.76000213623048,86.68639173461268,-13.313608265387325,4.703234054008547,3.9113525422762505,0.0794784072803345,1589897700.0,1.0
545,2023-11-24,AMD,122.02999877929688,123.25,121.54000091552734,122.30999755859376,19001000.0,0.0,0.0,-0.20000457763671875,0.20000457763671875,0.0,70.11634295896818,110.22000122070312,124.76000213623048,83.14990080213582,-16.850099197864175,4.737868299522816,4.076655693725565,0.031368592086840064,1570896700.0,-1.0
546,2023-11-27,AMD,122.06999969482422,123.88999938964844,121.7699966430664,122.6500015258789,32743000.0,0.0,0.0,0.34000396728514204,0.0,0.34000396728514204,70.92592208166887,111.22000122070312,124.76000213623048,84.4165401205263,-15.583459879473693,4.738133413757538,4.208951237731959,0.050175533559504215,1603639700.0,1.0
547,2023-11-28,AMD,121.9800033569336,122.54000091552734,120.79000091552734,122.01000213623048,32047100.0,0.0,0.0,-0.6399993896484233,0.6399993896484233,0.0,66.98458216973961,112.87999725341795,124.76000213623048,76.85186136599506,-23.14813863400494,4.633291220535881,4.2938192342927435,0.01776780890568297,1571592600.0,-1.0
548,2023-11-29,AMD,123.9800033569336,125.7300033569336,123.4800033569336,123.8499984741211,37876300.0,0.0,0.0,1.8399963378906108,0.0,1.8399963378906108,72.12340786601621,113.05999755859376,125.7300033569336,85.16176777867899,-14.838232221321004,4.645129192978189,4.364081226029833,0.04957625825526346,1609468900.0,1.0
549,2023-11-30,AMD,123.61000061035156,124.0500030517578,119.6500015258789,121.16000366210938,44494200.0,0.0,0.0,-2.6899948120117188,2.6899948120117188,0.0,57.124711879677385,114.02999877929688,125.7300033569336,60.94018883070119,-39.05981116929881,4.386881535688033,4.368641287961473,0.011099072108250896,1564974700.0,-1.0
550,2023-12-01,AMD,119.87999725341795,121.4000015258789,118.6500015258789,121.38999938964844,37017600.0,0.0,0.0,0.2299957275390625,0.0,0.2299957275390625,57.98665917895709,116.0,125.7300033569336,55.39565806837597,-44.60434193162403,4.152905035191353,4.325494037407449,0.0063836563217805065,1601992300.0,1.0
551,2023-12-04,AMD,119.75,119.9000015258789,116.37000274658205,118.56999969482422,39854400.0,0.0,0.0,-2.8199996948242188,2.8199996948242188,0.0,45.146395478709834,116.37000274658205,125.7300033569336,23.504239367347054,-76.49576063265295,3.6973063230202854,4.199856494530016,-0.024356118770708868,1562137900.0,-1.0
552,2023-12-05,AMD,117.43000030517578,118.48999786376952,116.4499969482422,118.37999725341795,39191600.0,0.0,0.0,-0.1900024414062642,0.1900024414062642,0.0,44.382358707330916,116.37000274658205,125.7300033569336,21.474298886401638,-78.52570111359836,3.283064330342995,4.016498061692611,-0.00654587432628162,1522946300.0,-1.0
553,2023-12-06,AMD,120.69000244140624,122.83000183105467,116.37999725341795,116.81999969482422,60599000.0,0.0,0.0,-1.5599975585937358,1.5599975585937358,0.0,38.24990615051087,116.37000274658205,125.7300033569336,4.8076593899417706,-95.19234061005822,2.7966576740889337,3.7725299841718756,-0.046445207266252564,1462347300.0,-1.0
554,2023-12-07,AMD,120.79000091552734,128.67999267578125,119.55999755859376,128.3699951171875,118579100.0,0.0,0.0,11.549995422363281,0.0,11.549995422363281,71.6794800329982,116.37000274658205,128.67999267578125,97.48173994961249,-2.5182600503875157,3.305066239506587,3.6790372352388183,0.0495462160048743,1580926400.0,1.0
555,2023-12-08,AMD,129.5399932861328,131.0,126.88999938964844,128.9199981689453,89273900.0,0.0,0.0,0.5500030517578125,0.0,0.5500030517578125,72.4975597817922,116.37000274658205,131.0,85.78262322934651,-14.217376770653486,3.7096023527491866,3.6851502587408924,0.05112104822716579,1670200300.0,1.0
556,2023-12-11,AMD,130.55999755859375,135.0399932861328,128.25,134.41000366210938,98668300.0,0.0,0.0,5.4900054931640625,0.0,5.4900054931640625,79.3633342790508,116.37000274658205,135.0399932861328,96.62565643678897,-3.3743435632110192,4.4222210814835705,3.8325644232894285,0.10163102457808049,1768868600.0,1.0
557,2023-12-12,AMD,132.25,139.88999938964844,131.89999389648438,137.61000061035156,111677800.0,0.0,0.0,3.1999969482421875,0.0,3.1999969482421875,82.33006395199885,116.37000274658205,139.88999938964844,90.30612625546863,-9.69387374453138,5.185415325493807,4.103134603730305,0.11110215830245385,1880546400.0,1.0
558,2023-12-13,AMD,137.97000122070312,139.24000549316406,136.02999877929688,138.19000244140625,70651600.0,0.0,0.0,0.5800018310546875,0.0,0.5800018310546875,82.84581053086492,116.37000274658205,139.88999938964844,92.77212078708634,-7.227879212913664,5.770534433348672,4.436614569653979,0.14055792559061064,1951198000.0,1.0
559,2023-12-14,AMD,138.88999938964844,141.82000732421875,135.72999572753906,138.0,76115200.0,0.0,0.0,-0.19000244140625,0.19000244140625,0.0,81.94177712219626,116.37000274658205,141.82000732421875,84.99015073822247,-15.009849261777527,6.148043118711982,4.77890027946558,0.13683170519702625,1875082800.0,-1.0
560,2023-12-15,AMD,139.52000427246094,140.88999938964844,137.25,139.14999389648438,70178600.0,0.0,0.0,1.149993896484375,0.0,1.149993896484375,83.22050210618977,116.37000274658205,141.82000732421875,89.50878999023617,-10.491210009763831,6.46548626627434,5.116217476827332,0.1735683077897361,1945261400.0,1.0
561,2023-12-18,AMD,139.14999389648438,139.7899932861328,137.64999389648438,138.89999389648438,45199500.0,0.0,0.0,-0.25,0.25,0.0,81.7681277388823,116.37000274658205,141.82000732421875,88.52647189580377,-11.473528104196234,6.620571509941016,5.417088283450069,0.17334006689609005,1900061900.0,-1.0
562,2023-12-19,AMD,138.57000732421875,143.47000122070312,138.55999755859375,140.14999389648438,63739800.0,0.0,0.0,1.25,0.0,1.25,83.43589041372627,116.37000274658205,143.47000122070312,87.74904977434164,-12.250950225658364,6.7663440332713805,5.686939433414332,0.19970890483313197,1963801700.0,1.0
563,2023-12-20,AMD,139.0,139.5800018310547,135.3699951171875,135.47000122070312,54671700.0,0.0,0.0,-4.67999267578125,4.67999267578125,0.0,59.80330510829507,116.37000274658205,143.47000122070312,70.47970313489303,-29.520296865106964,6.430111194751802,5.835573785681826,0.05530892243965657,1909130000.0,-1.0
564,2023-12-21,AMD,138.13999938964844,139.97999572753906,137.3800048828125,139.91000366210938,47179400.0,0.0,0.0,4.44000244140625,0.0,4.44000244140625,69.31688081437176,116.37000274658205,143.47000122070312,86.86347690390706,-13.136523096092938,6.447591514473061,5.957977331440074,0.08524670841805349,1956309400.0,1.0
565,2023-12-22,AMD,140.47999572753906,140.6999969482422,138.30999755859375,139.60000610351562,35370400.0,0.0,0.0,-0.30999755859375,0.30999755859375,0.0,68.01996200334928,116.37999725341795,143.47000122070312,85.7143058308111,-14.285694169188904,6.363080945382961,6.038998054228652,0.03861321553456154,1920939000.0,-1.0
566,2023-12-26,AMD,140.07000732421875,143.85000610351562,139.9199981689453,143.41000366210938,47157400.0,0.0,0.0,3.80999755859375,0.0,3.80999755859375,74.72595215972581,116.37999725341795,143.85000610351562,98.39824426774916,-1.601755732250831,6.528286645638389,6.1368557725106,0.042148121691974794,1968096400.0,1.0
567,2023-12-27,AMD,144.72000122070312,146.25,143.17999267578125,146.07000732421875,49033400.0,0.0,0.0,2.660003662109375,0.0,2.660003662109375,78.37835097647489,119.55999755859376,146.25,99.32561761215123,-0.6743823878487686,6.795518905319767,6.268588399072434,0.05702297375784249,2017129800.0,1.0
568,2023-12-28,AMD,146.8000030517578,150.41000366210938,145.9499969482422,148.75999450683594,63800700.0,0.0,0.0,2.6899871826171875,0.0,2.6899871826171875,81.49819801477464,126.88999938964844,150.41000366210938,92.9846562264217,-7.015343773578296,7.142032969558329,6.443277313169613,0.07797097468721703,2080930500.0,1.0
569,2023-12-29,AMD,149.5,151.0500030517578,147.1999969482422,147.41000366210938,62028200.0,0.0,0.0,-1.3499908447265625,1.3499908447265625,0.0,75.21370844228647,128.25,151.0500030517578,84.03509253316611,-15.964907466833889,7.224436081425949,6.599509066820882,0.059360475227686615,2018902300.0,-1.0
570,2024-01-02,AMD,144.27999877929688,144.39999389648438,137.42999267578125,138.5800018310547,64902000.0,0.0,0.0,-8.830001831054688,8.830001831054688,0.0,47.54436185129069,131.89999389648438,151.0500030517578,34.88253128448664,-65.11746871551335,6.502279560303492,6.580063165517404,-0.0023037586716394554,1954000300.0,-1.0
571,2024-01-03,AMD,135.7100067138672,137.42999267578125,133.74000549316406,135.32000732421875,61988600.0,0.0,0.0,-3.2599945068359375,3.2599945068359375,0.0,41.102978115525254,133.74000549316406,151.0500030517578,9.12768373136065,-90.87231626863935,5.602330821195551,6.3845166966530345,-0.03446298096761302,1892011700.0,-1.0
572,2024-01-04,AMD,134.3000030517578,137.6999969482422,134.0,136.00999450683594,58610300.0,0.0,0.0,0.6899871826171875,0.0,0.6899871826171875,42.989269652091465,133.74000549316406,151.0500030517578,13.113745429414648,-86.88625457058535,4.888440264243059,6.08530141017104,0.003986072792994788,1950622000.0,1.0
573,2024-01-05,AMD,136.77999877929688,141.00999450683594,136.44000244140625,138.5800018310547,69595000.0,0.0,0.0,2.57000732421875,0.0,2.57000732421875,49.88701277754237,133.74000549316406,151.0500030517578,27.960699136481114,-72.03930086351889,4.478430408519188,5.76392720984067,-0.009506123909957975,2020217000.0,1.0
574,2024-01-08,AMD,140.36000061035156,147.14999389648438,140.14999389648438,146.17999267578125,71756900.0,0.0,0.0,7.5999908447265625,0.0,7.5999908447265625,64.53020362137596,133.74000549316406,151.0500030517578,71.86590951563255,-28.13409048436745,4.71242844583432,5.553627457039401,0.04713457223910478,2091973900.0,1.0
575,2024-01-09,AMD,145.9499969482422,149.86000061035156,145.0800018310547,149.25999450683594,67875700.0,0.0,0.0,3.0800018310546875,0.0,3.0800018310546875,68.79411134761918,133.74000549316406,151.0500030517578,89.65910573434364,-10.340894265656349,5.087755504282796,5.46045306648808,0.04079206955820047,2159849600.0,1.0
576,2024-01-10,AMD,150.07000732421875,150.8800048828125,146.64999389648438,148.5399932861328,56951200.0,0.0,0.0,-0.720001220703125,0.720001220703125,0.0,66.6335229363043,133.74000549316406,151.0500030517578,85.49965268840332,-14.50034731159668,5.2663990510448855,5.421642263399442,0.01690960387529561,2102898400.0,-1.0
577,2024-01-11,AMD,148.52000427246094,150.3800048828125,143.69000244140625,148.02000427246094,62764600.0,0.0,0.0,-0.519989013671875,0.519989013671875,0.0,64.93409630345218,133.74000549316406,151.0500030517578,82.4956718275642,-17.5043281724358,5.304865395192365,5.398286889758027,-0.004974390035628828,2040133800.0,-1.0
578,2024-01-12,AMD,148.0399932861328,148.75,145.0,146.55999755859375,48250800.0,0.0,0.0,-1.4600067138671875,1.4600067138671875,0.0,59.97831115842501,133.74000549316406,151.0500030517578,74.06120088714312,-25.938799112856874,5.15808076598384,5.35024566500319,-0.00576627150396114,1991883000.0,-1.0
579,2024-01-16,AMD,150.36000061035156,159.72000122070312,149.97999572753906,158.74000549316406,112711400.0,0.0,0.0,12.180007934570312,0.0,12.180007934570312,76.92808565312365,133.74000549316406,159.72000122070312,96.22788341531458,-3.772116584685412,5.955921579146207,5.471380847831794,0.14547556209940593,2104594400.0,1.0
580,2024-01-17,AMD,158.4499969482422,160.63999938964844,154.39999389648438,160.1699981689453,104085000.0,0.0,0.0,1.42999267578125,0.0,1.42999267578125,78.17995308764628,133.74000549316406,160.63999938964844,98.25278316972201,-1.7472168302779822,6.627210274709881,5.702546733207412,0.1836387045500778,2208679400.0,1.0
581,2024-01-18,AMD,166.1999969482422,168.60000610351562,158.22000122070312,162.6699981689453,131864900.0,0.0,0.0,2.5,0.0,2.5,80.33261324097143,133.74000549316406,168.60000610351562,82.98907679075192,-17.01092320924807,7.2770551466657025,6.017448415899071,0.19601503373907891,2340544300.0,1.0
582,2024-01-19,AMD,165.8000030517578,174.25,162.1999969482422,174.22999572753906,139825500.0,0.0,0.0,11.55999755859375,0.0,11.55999755859375,87.11487010140196,133.74000549316406,174.25,99.95061892082568,-0.04938107917433028,8.625428509469742,6.5390444346132055,0.25725208129197386,2480369800.0,1.0
583,2024-01-22,AMD,174.38999938964844,174.72000122070312,164.14999389648438,168.17999267578125,122973800.0,0.0,0.0,-6.0500030517578125,6.0500030517578125,0.0,72.1003714428111,133.74000549316406,174.72000122070312,84.04097309232537,-15.959026907674637,9.100929579285719,7.051421463547708,0.15049939186133865,2357396000.0,-1.0
584,2024-01-23,AMD,166.5,169.6300048828125,164.27000427246094,168.4199981689453,76830500.0,0.0,0.0,0.2400054931640625,0.0,0.2400054931640625,72.31875386263904,133.74000549316406,174.72000122070312,84.62663809522036,-15.373361904779637,9.388904592597186,7.518918089357603,0.12836663786177382,2434226500.0,1.0
585,2024-01-24,AMD,172.5500030517578,180.5800018310547,170.55999755859375,178.2899932861328,125516400.0,0.0,0.0,9.8699951171875,0.0,9.8699951171875,79.81560203795422,134.0,180.5800018310547,95.08370877006894,-4.9162912299310735,10.29488001491319,8.074110474468721,0.20028276117323185,2559742900.0,1.0
586,2024-01-25,AMD,183.41000366210935,184.9199981689453,177.6300048828125,180.3300018310547,127171400.0,0.0,0.0,2.040008544921875,0.0,2.040008544921875,81.04019007706322,136.44000244140625,184.9199981689453,90.53218493729513,-9.46781506270488,11.050104972921389,8.669309374159255,0.21828129054178813,2686914300.0,1.0
587,2024-01-26,AMD,175.2899932861328,181.22999572753903,174.14999389648438,177.25,107381200.0,0.0,0.0,-3.0800018310546875,3.0800018310546875,0.0,73.29365506950383,140.14999389648438,184.9199981689453,82.86799768374536,-17.132002316254646,11.270180164856413,9.189483532298686,0.20940231272272358,2579533100.0,-1.0
588,2024-01-29,AMD,178.77000427246094,178.88999938964844,174.39999389648438,177.8300018310547,89384500.0,0.0,0.0,0.5800018310546875,0.0,0.5800018310546875,73.83705546978327,143.69000244140625,184.9199981689453,82.8037907528694,-17.196209247130604,11.360436598956454,9.62367414563024,0.12025951667686385,2668917600.0,1.0
589,2024-01-30,AMD,176.1300048828125,178.47999572753906,169.52000427246094,172.05999755859375,122265700.0,0.0,0.0,-5.7700042724609375,5.7700042724609375,0.0,59.85683745602472,143.69000244140625,184.9199981689453,68.80911486061133,-31.190885139388662,10.841401423708021,9.867219601245797,0.07423362380954157,2546651900.0,-1.0
590,2024-01-31,AMD,165.74000549316406,171.3000030517578,162.55999755859375,167.69000244140625,133157300.0,0.0,0.0,-4.3699951171875,4.3699951171875,0.0,51.35899264908942,143.69000244140625,184.9199981689453,58.210047264131774,-41.789952735868226,9.962597600134899,9.886295201023618,0.030860049972136094,2413494600.0,-1.0
591,2024-02-01,AMD,169.27000427246094,171.13999938964844,165.86000061035156,170.47999572753906,91576700.0,0.0,0.0,2.7899932861328125,0.0,2.7899932861328125,55.964409695197276,145.0,184.9199981689453,63.82764753571693,-36.17235246428308,9.38310577696464,9.785657316211823,-0.02152327436123136,2505071300.0,1.0
592,2024-02-02,AMD,173.7899932861328,179.0,173.0500030517578,177.66000366210938,82078100.0,0.0,0.0,7.1800079345703125,0.0,7.1800079345703125,65.62804116225334,149.97999572753906,184.9199981689453,79.22153978377415,-20.778460216225845,9.39492215173783,9.707510283317026,0.05636824473291413,2587149400.0,1.0
593,2024-02-05,AMD,179.08999633789062,180.00999450683594,171.11000061035156,174.22999572753906,76349200.0,0.0,0.0,-3.4300079345703125,3.4300079345703125,0.0,58.54609563585154,154.39999389648438,184.9199981689453,64.97378458412555,-35.02621541587444,9.02349648890501,9.570707524434624,0.0344970764859267,2510800200.0,-1.0
594,2024-02-06,AMD,173.14999389648438,173.8800048828125,165.5,167.8800048828125,68854100.0,0.0,0.0,-6.3499908447265625,6.3499908447265625,0.0,47.57873935370039,158.22000122070312,184.9199981689453,36.17979313194397,-63.82020686805604,8.123109631972,9.281187945942099,-0.05838795667356156,2441946100.0,-1.0
595,2024-02-07,AMD,169.47000122070312,172.97000122070312,168.1999969482422,170.94000244140625,53665400.0,0.0,0.0,3.05999755859375,0.0,3.05999755859375,52.52384362490257,162.1999969482422,184.9199981689453,38.468331969982096,-61.531668030017904,7.569209653076371,8.938792287368953,-0.0520711988815129,2495611500.0,1.0
596,2024-02-08,AMD,170.3300018310547,172.1699981689453,168.60000610351562,169.35000610351562,43385300.0,0.0,0.0,-1.589996337890625,1.589996337890625,0.0,49.71223888798578,162.55999755859375,184.9199981689453,30.366763683264125,-69.63323631673587,6.922146319035761,8.535463093702315,-0.044569782208656594,2452226200.0,-1.0
597,2024-02-09,AMD,171.0,175.10000610351562,168.66000366210938,172.47999572753906,56375700.0,0.0,0.0,3.1299896240234375,0.0,3.1299896240234375,55.163804029889185,162.55999755859375,184.9199981689453,44.364927988207874,-55.63507201179212,6.585988789955252,8.145568232952902,-0.03008494656935523,2508601900.0,1.0
598,2024-02-12,AMD,172.67999267578125,177.41000366210938,170.6699981689453,171.91000366210938,58177100.0,0.0,0.0,-0.5699920654296875,0.5699920654296875,0.0,53.93521913377634,162.55999755859375,184.9199981689453,41.81576855229172,-58.18423144770828,6.202094050686497,7.756873396499621,-0.000871753450032986,2450424800.0,-1.0
599,2024-02-13,AMD,167.94000244140625,173.1699981689453,164.3000030517578,171.5399932861328,63071300.0,0.0,0.0,-0.3700103759765625,0.3700103759765625,0.0,53.05024343428801,162.55999755859375,184.9199981689453,40.160981585044205,-59.83901841495579,5.8011261873649005,7.365723954672677,0.022958976615626403,2387353500.0,-1.0
600,2024-02-14,AMD,173.47000122070312,178.74000549316406,172.8800048828125,178.6999969482422,57402500.0,0.0,0.0,7.160003662109375,0.0,7.160003662109375,65.63876887744232,162.55999755859375,181.22999572753903,86.44885362921397,-13.551146370786027,5.9920362594441485,7.090986415626972,0.04821680799335737,2444756000.0,1.0
601,2024-02-15,AMD,179.13999938964844,180.5,175.25999450683594,176.75999450683594,51126400.0,0.0,0.0,-1.94000244140625,1.94000244140625,0.0,60.56209413022017,162.55999755859375,180.5,79.15270354405315,-20.847296455946847,5.91856633477741,6.856502399457059,-0.005065907557815663,2393629600.0,-1.0
602,2024-02-16,AMD,177.4499969482422,180.3300018310547,173.25,173.8699951171875,53896000.0,0.0,0.0,-2.8899993896484375,2.8899993896484375,0.0,53.45559853732043,162.55999755859375,180.5,63.04345607272504,-36.95654392727496,5.5630151168068664,6.597804942927021,-0.002066237841815366,2339733600.0,-1.0
603,2024-02-20,AMD,171.13999938964844,171.80999755859375,162.0,165.69000244140625,66550000.0,0.0,0.0,-8.17999267578125,8.17999267578125,0.0,38.645533029689226,162.0,180.5,19.945959142736484,-80.05404085726352,4.568518135999909,6.1919475815416,-0.0130450463289834,2273183600.0,-1.0
604,2024-02-21,AMD,162.74000549316406,164.89999389648438,161.80999755859375,164.2899932861328,48774600.0,0.0,0.0,-1.4000091552734375,1.4000091552734375,0.0,36.640808525671105,161.80999755859375,180.5,13.269103282966002,-86.730896717034,3.6256093080723133,5.678679926847743,-0.038902591905325856,2224409000.0,-1.0
605,2024-02-22,AMD,173.1999969482422,183.8300018310547,172.0,181.8600006103516,100684700.0,0.0,0.0,17.57000732421878,0.0,17.57000732421878,63.819156620247746,161.80999755859375,183.8300018310547,91.05358383982308,-8.946416160176934,4.2471416158784905,5.392372264653893,0.07387064692037382,2325093700.0,1.0
606,2024-02-23,AMD,181.8600006103516,183.8000030517578,174.5500030517578,176.52000427246094,69207400.0,0.0,0.0,-5.339996337890653,5.339996337890653,0.0,55.4742447953653,161.80999755859375,183.8300018310547,66.80292397701342,-33.19707602298658,4.2597140396862585,5.165840619660367,0.02342305568759251,2255886300.0,-1.0
607,2024-02-26,AMD,178.77999877929688,179.83999633789062,174.80999755859375,176.00999450683594,45435100.0,0.0,0.0,-0.510009765625,0.510009765625,0.0,54.68623045770971,161.80999755859375,183.8300018310547,64.48680378323654,-35.51319621676346,4.180335939838415,4.9687396836959765,0.02384963502638926,2210451200.0,-1.0
608,2024-02-27,AMD,175.9199981689453,178.4600067138672,172.49000549316406,178.0,43665200.0,0.0,0.0,1.9900054931640625,0.0,1.9900054931640625,57.410021761067775,161.80999755859375,183.8300018310547,73.52406584976956,-26.47593415023044,4.229252841773615,4.820842315311505,0.0376588956902415,2254116400.0,1.0
609,2024-02-28,AMD,176.25,176.83999633789062,173.58999633789062,176.5399932861328,35914400.0,0.0,0.0,-1.4600067138671875,1.4600067138671875,0.0,54.6301515051547,161.80999755859375,183.8300018310547,66.89370058824629,-33.106299411753696,4.10291366423499,4.677256585096202,-0.012087317845534074,2218202000.0,-1.0
610,2024-02-29,AMD,179.82000732421875,193.0,179.82000732421875,192.52999877929688,105538500.0,0.0,0.0,15.990005493164062,0.0,15.990005493164062,71.85313811791866,161.80999755859375,193.0,98.49310296917714,-1.5068970308228493,5.232729120787923,4.788351092234546,0.08921704436832312,2323740500.0,1.0
611,2024-03-01,AMD,197.91000366210935,202.72000122070312,195.4199981689453,202.63999938964844,103583000.0,0.0,0.0,10.110000610351562,0.0,10.110000610351562,77.95763416311198,161.80999755859375,202.72000122070312,99.8044443317203,-0.19555566827969945,6.8647757051521126,5.203636014818059,0.16546848266183067,2427323500.0,1.0
612,2024-03-04,AMD,205.16000366210935,211.00999450683597,203.5,205.3600006103516,86835300.0,0.0,0.0,2.7200012207031534,0.0,2.7200012207031534,79.34805605237625,161.80999755859375,211.00999450683597,88.51627185581312,-11.483728144186875,8.282193773660111,5.819347566586471,0.239423004311766,2514158800.0,1.0
613,2024-03-05,AMD,200.5,205.3300018310547,199.1499938964844,205.1300048828125,65407100.0,0.0,0.0,-0.22999572753909092,0.22999572753909092,0.0,78.86270204528108,161.80999755859375,211.00999450683597,88.04880083588391,-11.951199164116092,9.279975293242472,6.511473111917672,0.2485849002717493,2448751700.0,-1.0
614,2024-03-06,AMD,210.42999267578125,214.80999755859372,207.32000732421875,210.6300048828125,86687000.0,0.0,0.0,5.5,0.0,5.5,81.91502852246342,161.80999755859375,214.80999755859372,92.11322136645053,-7.886778633549479,10.394704685525085,7.288119426639156,0.1581986372808981,2535438700.0,1.0
615,2024-03-07,AMD,212.5200042724609,213.8300018310547,208.22000122070312,211.3800048828125,63869000.0,0.0,0.0,0.75,0.0,0.75,82.31680882136509,161.80999755859375,214.80999755859372,93.52831570607316,-6.471684293926836,11.209439056271094,8.072383352565543,0.19748470296060439,2599307700.0,1.0
616,2024-03-08,AMD,213.41000366210935,227.3000030517578,205.6000061035156,207.38999938964844,120592600.0,0.0,0.0,-3.9900054931640625,3.9900054931640625,0.0,72.43814379183547,161.80999755859375,227.3000030517578,69.59840892945472,-30.401591070545276,11.401729774027842,8.738252636858004,0.17828535800331347,2478715100.0,-1.0
617,2024-03-11,AMD,203.00999450683597,203.5500030517578,196.6999969482422,198.38999938964844,73098600.0,0.0,0.0,-9.0,9.0,0.0,55.197724289037275,161.80999755859375,227.3000030517578,55.85585396671399,-44.14414603328601,10.704501934460353,9.131502496378474,0.11455055836881134,2405616500.0,-1.0
618,2024-03-12,AMD,200.5200042724609,202.8500061035156,194.2700042724609,202.75999450683597,68951700.0,0.0,0.0,4.369995117187528,0.0,4.369995117187528,60.46888148281454,172.0,227.3000030517578,55.62385679806613,-44.37614320193387,10.384855779618164,9.382173153026413,0.14852159407418952,2474568200.0,1.0
619,2024-03-13,AMD,198.72999572753903,198.8300018310547,192.6999969482422,194.7899932861328,70526900.0,0.0,0.0,-7.970001220703153,7.970001220703153,0.0,48.4685938287137,172.49000549316406,227.3000030517578,40.68598574398641,-59.31401425601359,9.3802912501003,9.38179677244119,0.011738401917441577,2404041300.0,-1.0
620,2024-03-14,AMD,192.9199981689453,196.92999267578125,184.02999877929688,187.05999755859372,84490500.0,0.0,0.0,-7.729995727539091,7.729995727539091,0.0,39.66042122751563,172.49000549316406,227.3000030517578,26.582727083419122,-73.41727291658088,7.869703526534352,9.079378123259822,-0.07688512573026884,2319550800.0,-1.0
621,2024-03-15,AMD,184.8300018310547,193.8000030517578,184.47999572753903,191.05999755859372,95225700.0,0.0,0.0,4.0,0.0,4.0,45.56675843379125,172.49000549316406,227.3000030517578,33.88066574091288,-66.11933425908711,6.915599714297542,8.646622441467366,-0.06963382844398491,2414776500.0,1.0
622,2024-03-18,AMD,193.2899932861328,193.5,188.0500030517578,190.6499938964844,59306900.0,0.0,0.0,-0.41000366210931816,0.41000366210931816,0.0,45.04527459470385,173.58999633789062,227.3000030517578,31.763164077559352,-68.23683592244065,6.056565384495116,8.128611030072916,-0.07058943422050956,2355469600.0,-1.0
623,2024-03-19,AMD,183.16000366210935,185.6100006103516,177.36000061035156,181.4199981689453,83509500.0,0.0,0.0,-9.229995727539091,9.229995727539091,0.0,34.723069203316044,177.36000061035156,227.3000030517578,8.12975042073191,-91.87024957926809,4.57821614635202,7.418532053328737,-0.1386792291540736,2271960100.0,-1.0
624,2024-03-20,AMD,182.02999877929688,182.67999267578125,174.0,179.72999572753906,81773100.0,0.0,0.0,-1.69000244140625,1.69000244140625,0.0,33.11966530278461,174.0,227.3000030517578,10.750460411746806,-89.24953958825319,3.232976905807334,6.581421023824457,-0.14973038331047428,2190187000.0,-1.0
625,2024-03-21,AMD,185.97000122070312,187.69000244140625,177.66000366210938,178.67999267578125,75265600.0,0.0,0.0,-1.0500030517578125,1.0500030517578125,0.0,32.05841456154009,174.0,227.3000030517578,8.780473560642518,-91.21952643935748,2.058410568996891,5.676818932858944,-0.1384348657040413,2114921400.0,-1.0
626,2024-03-22,AMD,177.2100067138672,180.75999450683597,175.0500030517578,179.64999389648438,57832100.0,0.0,0.0,0.970001220703125,0.0,0.970001220703125,34.30235585189814,174.0,227.3000030517578,10.600363176335767,-89.39963682366422,1.1920876324714698,4.779872672781449,-0.09446043424980155,2172753500.0,1.0
627,2024-03-25,AMD,172.89999389648438,182.8000030517578,172.0,178.6300048828125,71935300.0,0.0,0.0,-1.019989013671875,1.019989013671875,0.0,32.980733885924465,172.0,227.3000030517578,11.989158258467317,-88.01084174153269,0.4183929018283834,3.9075767185908363,-0.11900764587567558,2100818200.0,-1.0
628,2024-03-26,AMD,179.5399932861328,182.6000061035156,176.3300018310547,177.8699951171875,65322400.0,0.0,0.0,-0.760009765625,0.760009765625,0.0,31.923277748415217,172.0,227.3000030517578,10.614818794301877,-89.38518120569813,-0.2531737533585954,3.07542662420095,-0.0868627688902428,2035495800.0,-1.0
629,2024-03-27,AMD,179.9600067138672,181.22999572753903,175.39999389648438,179.58999633789062,55685600.0,0.0,0.0,1.720001220703125,0.0,1.720001220703125,37.18270851859976,172.0,227.3000030517578,13.725128244182553,-86.27487175581746,-0.6392367191282062,2.3324939555351185,-0.039933718155658715,2091181400.0,1.0
630,2024-03-28,AMD,179.47000122070312,183.3999938964844,178.3000030517578,180.4900054931641,57628600.0,0.0,0.0,0.9000091552734659,0.0,0.9000091552734659,39.982243765985686,172.0,203.5500030517578,26.90968200299768,-73.09031799700232,-0.8626273526420505,1.6934696938996847,-0.05532289438132154,2148810000.0,1.0
631,2024-04-01,AMD,180.10000610351562,187.2400054931641,179.89999389648438,183.33999633789065,74299900.0,0.0,0.0,2.8499908447265625,0.0,2.8499908447265625,48.38675300268807,172.0,202.8500061035156,36.758489770925436,-63.241510229074564,-0.8004682961067715,1.1946820958983935,-0.03834250087919122,2223109900.0,1.0
632,2024-04-02,AMD,179.47000122070312,180.10000610351562,174.8300018310547,178.6999969482422,61598800.0,0.0,0.0,-4.639999389648466,4.639999389648466,0.0,38.30914560764399,172.0,198.8300018310547,24.972033138243027,-75.02796686175698,-1.1127884362046245,0.7331879894777897,-0.014992841187056793,2161511100.0,-1.0
633,2024-04-03,AMD,177.5399932861328,182.0500030517578,176.6999969482422,180.7700042724609,49835100.0,0.0,0.0,2.0700073242187216,0.0,2.0700073242187216,44.282576531959954,172.0,196.92999267578125,35.17852727241556,-64.82147272758444,-1.1796735635711286,0.350615678868006,0.005786505144630638,2211346200.0,1.0
634,2024-04-04,AMD,182.9199981689453,183.0200042724609,165.64999389648438,165.8300018310547,88280000.0,0.0,0.0,-14.940002441406222,14.940002441406222,0.0,24.514792804094412,165.64999389648438,193.8000030517578,0.6394595951191404,-99.36054040488087,-2.410427934281472,-0.20159304376188977,-0.07191622661437624,2123066200.0,-1.0
635,2024-04-05,AMD,168.10000610351562,172.69000244140625,165.5800018310547,170.4199981689453,66025200.0,0.0,0.0,4.589996337890625,0.0,4.589996337890625,34.828040642281266,165.5800018310547,193.5,17.33523157345342,-82.66476842654657,-2.981071360920822,-0.7574887071936764,-0.051377656783319736,2189091400.0,1.0
636,2024-04-08,AMD,168.1999969482422,171.66000366210938,166.82000732421875,169.89999389648438,43997500.0,0.0,0.0,-0.5200042724609375,0.5200042724609375,0.0,34.21693376433818,165.5800018310547,187.69000244140625,19.538633858775807,-80.4613661412242,-3.4356661657943164,-1.2931241989138047,-0.04887203016120001,2145093900.0,-1.0
637,2024-04-09,AMD,170.2100067138672,171.60000610351562,167.2899932861328,170.77999877929688,42928000.0,0.0,0.0,0.8800048828125,0.0,0.8800048828125,36.39613682645128,165.5800018310547,187.69000244140625,23.51875533557258,-76.48124466442742,-3.6824774762180823,-1.7709948543746605,-0.03986055283365508,2188021900.0,1.0
638,2024-04-10,AMD,166.7100067138672,169.77999877929688,164.0,167.13999938964844,59600000.0,0.0,0.0,-3.6399993896484375,3.6399993896484375,0.0,31.42729940961884,164.0,187.69000244140625,13.254533837279107,-86.7454661627209,-4.1242529274138064,-2.24164646898249,-0.06932455705839025,2128421900.0,-1.0
639,2024-04-11,AMD,167.5500030517578,170.9499969482422,166.5500030517578,170.5,48932900.0,0.0,0.0,3.3600006103515625,0.0,3.3600006103515625,40.13246132221774,164.0,187.2400054931641,27.969012321928822,-72.03098767807118,-4.15533902508048,-2.624384980202088,-0.055349355582697046,2177354800.0,1.0
13,2023-01-23,GOOG,99.12999725341795,101.4000015258789,98.75,101.20999908447266,31791800.0,0.0,0.0,1.9300003051757812,0.0,1.9300003051757812,88.59031954409451,85.56999969482422,101.4000015258789,98.79973203140437,-1.2002679685956228,1.2787042489061662,0.46714807415020765,0.13975220277280376,115784500.0,1.0
14,2023-01-24,GOOG,99.5500030517578,101.08999633789062,98.6999969482422,99.20999908447266,27391400.0,0.0,0.0,-2.0,2.0,0.0,74.00958660956512,85.56999969482422,101.4000015258789,86.1654947056924,-13.834505294307595,1.4330038299353305,0.6603192253072323,0.11172121760830778,88393100.0,-1.0
15,2023-01-25,GOOG,97.1999969482422,97.72000122070312,95.26200103759766,96.7300033569336,31000900.0,0.0,0.0,-2.4799957275390625,2.4799957275390625,0.0,59.903300652879956,85.56999969482422,101.4000015258789,70.49906741145229,-29.50093258854772,1.3816631785800695,0.8045880159617999,0.0484500446260856,57392200.0,-1.0
16,2023-01-26,GOOG,98.27999877929688,99.20999908447266,96.81999969482422,99.16000366210938,24542100.0,0.0,0.0,2.4300003051757812,0.0,2.4300003051757812,67.01191713393192,85.56999969482422,101.4000015258789,85.84966769002395,-14.150332309976047,1.4757419263385998,0.9388187980371601,0.07888151138208332,81934300.0,1.0
17,2023-01-27,GOOG,99.0500030517578,101.58000183105467,98.97000122070312,100.70999908447266,29020400.0,0.0,0.0,1.5499954223632812,0.0,1.5499954223632812,70.81943655749322,86.69999694824219,101.58000183105467,94.15320926684014,-5.846790733159873,1.6274015078617623,1.0765353400020807,0.08523702341155293,110954700.0,1.0
18,2023-01-30,GOOG,98.74500274658205,99.40899658203124,97.5199966430664,97.9499969482422,24365100.0,0.0,0.0,-2.7600021362304545,2.7600021362304545,0.0,57.244299946742714,86.69999694824219,101.58000183105467,75.60481390026023,-24.395186099739778,1.5471080510298663,1.1706498822076379,0.06282544548675317,86589600.0,-1.0
19,2023-01-31,GOOG,97.86000061035156,99.91000366210938,97.79000091552734,99.87000274658205,22306800.0,0.0,0.0,1.9200057983398438,0.0,1.9200057983398438,62.945584728184585,89.73999786376953,101.58000183105467,85.55744500426276,-14.442554995737241,1.5917070775699642,1.2548613212801032,0.088145609881072,108896400.0,1.0
20,2023-02-01,GOOG,99.73999786376952,102.19000244140624,98.41999816894533,101.43000030517578,26392600.0,0.0,0.0,1.5599975585937358,0.0,1.5599975585937358,67.06306208379883,90.56999969482422,102.19000244140624,93.45953565756251,-6.540464342437496,1.7102965254888005,1.3459483621218429,0.08007663028236633,135289000.0,1.0
21,2023-02-02,GOOG,106.79000091552734,108.81999969482422,106.54000091552734,108.8000030517578,46622600.0,0.0,0.0,7.370002746582017,0.0,7.370002746582017,79.48794072787112,90.83999633789062,108.81999969482422,99.88878398591228,-0.1112160140877237,2.2760833028138876,1.531975350260252,0.09589045517238826,181911600.0,1.0
22,2023-02-03,GOOG,103.51000213623048,108.0199966430664,103.3000030517578,105.22000122070312,36823400.0,0.0,0.0,-3.5800018310546733,3.5800018310546733,0.0,65.61481429514785,90.83999633789062,108.81999969482422,79.97776528371541,-20.022234716284597,2.444676327232628,1.7145155456547274,0.03962061231601832,145088200.0,-1.0
23,2023-02-06,GOOG,102.68499755859376,104.6999969482422,102.20999908447266,103.47000122070312,25573000.0,0.0,0.0,-1.75,1.75,0.0,59.734493854203286,91.37999725341795,108.81999969482422,69.32340753910067,-30.676592460899332,2.426456670916238,1.8569037707070297,0.04293924176537156,119515200.0,-1.0
24,2023-02-07,GOOG,103.62999725341795,108.66999816894533,103.5479965209961,108.04000091552734,33738800.0,0.0,0.0,4.569999694824219,0.0,4.569999694824219,68.29582933328317,91.37999725341795,108.81999969482422,95.52753056132039,-4.472469438679622,2.701398060942253,2.0258026287540742,0.11692336571993978,153254000.0,1.0
25,2023-02-08,GOOG,102.69000244140624,103.58000183105467,98.45500183105467,100.0,73546000.0,0.0,0.0,-8.040000915527344,8.040000915527344,0.0,47.70545543636243,95.26200103759766,108.81999969482422,34.94615305834197,-65.05384694165804,2.3192268965703136,2.0844874823173223,0.008471120480722627,79708000.0,-1.0
26,2023-02-09,GOOG,100.54000091552734,100.61000061035156,93.86000061035156,95.45999908447266,97798600.0,0.0,0.0,-4.540000915527344,4.540000915527344,0.0,39.873018406125524,93.86000061035156,108.81999969482422,10.695177620577336,-89.30482237942266,1.6725563498002316,2.002101255813904,-0.05212987834104188,-18090600.0,-1.0
27,2023-02-10,GOOG,95.73999786376952,97.0199966430664,94.52999877929688,94.86000061035156,49325300.0,0.0,0.0,-0.5999984741210938,0.5999984741210938,0.0,38.89912634570539,93.86000061035156,108.81999969482422,6.684492387689543,-93.31550761231045,1.1059307781215608,1.8228671602754354,-0.03154667109916731,-67415900.0,-1.0
28,2023-02-13,GOOG,95.01000213623048,95.3499984741211,94.0500030517578,95.0,43116600.0,0.0,0.0,0.1399993896484375,0.0,0.1399993896484375,39.29829506858182,93.86000061035156,108.81999969482422,7.620317242075705,-92.3796827579243,0.6610618148162217,1.5905060911835927,-0.04876341857063493,-24299300.0,1.0
29,2023-02-14,GOOG,94.66000366210938,95.1750030517578,92.6500015258789,94.9499969482422,42513100.0,0.0,0.0,-0.05000305175779829,0.05000305175779829,0.0,39.1927754097201,92.6500015258789,108.81999969482422,14.223844667963329,-85.77615533203668,0.3024652287152634,1.332897918689927,-0.0638864570387162,-66812400.0,-1.0
30,2023-02-15,GOOG,94.73999786376952,97.33999633789062,94.36000061035156,97.0999984741211,36964500.0,0.0,0.0,2.150001525878892,0.0,2.150001525878892,46.3409160354461,92.6500015258789,108.81999969482422,27.52008319202202,-72.47991680797799,0.1761314897947699,1.1015446329108955,-0.107536803763423,-29847900.0,1.0
31,2023-02-16,GOOG,95.54000091552734,97.87999725341795,94.97000122070312,95.77999877929688,35642100.0,0.0,0.0,-1.3199996948242188,1.3199996948242188,0.0,42.778486438188914,92.6500015258789,108.81999969482422,19.356818848805858,-80.64318115119414,-0.02178177646167967,0.8768793510363805,-0.08971680604342014,-65490000.0,-1.0
32,2023-02-17,GOOG,95.06999969482422,95.75,93.4499969482422,94.58999633789062,31095100.0,0.0,0.0,-1.19000244140625,1.19000244140625,0.0,39.61096861877155,92.6500015258789,108.81999969482422,11.997495557776276,-88.00250444222372,-0.26434325881464815,0.6486348290661748,-0.08582202356286162,-96585100.0,-1.0
33,2023-02-21,GOOG,93.23999786376952,93.41500091552734,92.0,92.0500030517578,28367200.0,0.0,0.0,-2.5399932861328267,2.5399932861328267,0.0,33.501653606109244,92.0,108.81999969482422,0.29728330954241944,-99.70271669045758,-0.6400722766919955,0.3908934079145407,-0.14800071943975235,-124952300.0,-1.0
34,2023-02-22,GOOG,91.93399810791016,92.36000061035156,90.87000274658205,91.8000030517578,29891100.0,0.0,0.0,-0.25,0.25,0.0,32.92494365683649,90.87000274658205,108.81999969482422,5.181061076819998,-94.81893892318,-0.9452443415819545,0.12366585801524162,-0.08199996948242205,-154843400.0,-1.0
35,2023-02-23,GOOG,92.12999725341795,92.12999725341795,90.01000213623047,91.06999969482422,32423700.0,0.0,0.0,-0.7300033569335795,0.7300033569335795,0.0,31.120000416111054,90.01000213623047,108.66999816894533,5.680588338472064,-94.31941166152794,-1.2279691258329706,-0.1466611387544009,-0.04598784236069098,-187267100.0,-1.0
36,2023-02-24,GOOG,89.62999725341797,90.12999725341795,88.86000061035156,89.3499984741211,31295600.0,0.0,0.0,-1.720001220703125,1.720001220703125,0.0,27.08358008281934,88.86000061035156,108.66999816894533,2.4734877544543945,-97.5265122455456,-1.5649521391016634,-0.4303193388238535,-0.0580856219774174,-218562700.0,-1.0
37,2023-02-27,GOOG,90.08999633789062,90.4499969482422,89.61000061035156,90.0999984741211,22724300.0,0.0,0.0,0.75,0.0,0.75,31.550493431648732,88.86000061035156,108.66999816894533,6.259454904534343,-93.74054509546565,-1.7537732661518675,-0.6950101242894564,-0.051578963430304325,-195838400.0,1.0
38,2023-02-28,GOOG,89.54000091552734,91.4499969482422,89.5199966430664,90.3000030517578,30546900.0,0.0,0.0,0.20000457763670454,0.0,0.20000457763670454,32.81688756373886,88.86000061035156,103.58000183105467,9.78262447003692,-90.21737552996308,-1.8661770368996287,-0.929243506811491,-0.04897308105253695,-165291500.0,1.0
39,2023-03-01,GOOG,90.16000366210938,91.1999969482422,89.8499984741211,90.51000213623048,26323900.0,0.0,0.0,0.20999908447268467,0.0,0.20999908447268467,34.289732995229656,88.86000061035156,100.61000061035156,14.042566177692938,-85.95743382230707,-1.9166928802230245,-1.1267333814937979,-0.06786814048866296,-138967600.0,1.0
40,2023-03-02,GOOG,89.86000061035156,92.4800033569336,89.7699966430664,92.30999755859376,23328600.0,0.0,0.0,1.7999954223632812,0.0,1.7999954223632812,45.998358589808824,88.86000061035156,97.87999725341795,38.248317430297384,-61.751682569702616,-1.7963004084075038,-1.2606467868765392,-0.036228871005719476,-115639000.0,1.0
41,2023-03-03,GOOG,92.73999786376952,94.11000061035156,92.66000366210938,94.0199966430664,30242500.0,0.0,0.0,1.709999084472642,0.0,1.709999084472642,54.822411716475585,88.86000061035156,97.87999725341795,57.206185732688674,-42.793814267311326,-1.5500103656531934,-1.3185195026318701,-0.006026003984481498,-85396500.0,1.0
42,2023-03-06,GOOG,94.36000061035156,96.3000030517578,94.3000030517578,95.58000183105467,28288200.0,0.0,0.0,1.560005187988267,0.0,1.560005187988267,61.452710121765136,88.86000061035156,97.87999725341795,74.50114990750832,-25.498850092491683,-1.2191733866023924,-1.2986502794259747,0.03834870898713638,-57108300.0,1.0
43,2023-03-07,GOOG,95.41999816894533,96.08999633789062,93.84400177001952,94.16999816894533,24101500.0,0.0,0.0,-1.4100036621093466,1.4100036621093466,0.0,53.295483257415725,88.86000061035156,97.87999725341795,58.86917444337989,-41.13082555662012,-1.0551259633568293,-1.2499454162121457,0.02581693941612717,-81209800.0,-1.0
44,2023-03-08,GOOG,94.40499877929688,96.23999786376952,94.40499877929688,94.6500015258789,25395200.0,0.0,0.0,0.48000335693357954,0.0,0.48000335693357954,55.60999118395655,88.86000061035156,97.87999725341795,64.19072140096722,-35.80927859903277,-0.8774071998948756,-1.1754377729486918,0.03931044079335977,-55814600.0,1.0
45,2023-03-09,GOOG,94.48999786376952,95.91999816894533,92.3550033569336,92.66000366210938,24438900.0,0.0,0.0,-1.9899978637695312,1.9899978637695312,0.0,44.95339461794611,88.86000061035156,96.3000030517578,51.075293075301374,-48.924706924698626,-0.8826787165070584,-1.1168859616603652,0.037045386060605034,-80253500.0,-1.0
46,2023-03-10,GOOG,92.5,93.18000030517578,90.8000030517578,91.01000213623048,32850100.0,0.0,0.0,-1.650001525878892,1.650001525878892,0.0,37.988731248400114,88.86000061035156,96.3000030517578,28.897860488773553,-71.10213951122645,-1.005056537460007,-1.0945200768202936,0.010099929828198295,-113103600.0,-1.0
47,2023-03-13,GOOG,90.56500244140624,93.08000183105467,89.94000244140625,91.66000366210938,31508600.0,0.0,0.0,0.650001525878892,0.0,0.650001525878892,42.068454372895346,88.86000061035156,96.3000030517578,37.63443727081067,-62.36556272918933,-1.0387441140076277,-1.0833648842577606,0.015060914334322328,-81595000.0,1.0
48,2023-03-14,GOOG,93.06999969482422,94.83000183105467,92.77999877929688,94.25,32303900.0,0.0,0.0,2.589996337890625,0.0,2.589996337890625,55.52202968696083,88.86000061035156,96.3000030517578,72.44620458255754,-27.553795417442455,-0.8510506614144049,-1.0369020396890893,0.04132137637274913,-49291100.0,1.0
49,2023-03-15,GOOG,93.54000091552734,97.25,93.04000091552734,96.5500030517578,38367300.0,0.0,0.0,2.3000030517577983,0.0,2.3000030517577983,64.0714943533168,88.86000061035156,97.25,91.65676997419266,-8.343230025807348,-0.5144685764235817,-0.9324153470359878,0.04593224575130872,-10923800.0,1.0
50,2023-03-16,GOOG,96.56999969482422,101.97000122070312,95.87000274658205,101.06999969482422,54499500.0,0.0,0.0,4.5199966430664205,0.0,4.5199966430664205,74.97778940862409,89.5199966430664,101.97000122070312,92.77107473923719,-7.2289252607628045,0.10900172933489216,-0.7241319317618118,0.0749840810835396,43575700.0,1.0
51,2023-03-17,GOOG,100.83999633789062,103.48999786376952,100.75,102.45999908447266,76140300.0,0.0,0.0,1.3899993896484375,0.0,1.3899993896484375,77.41089783210063,89.5199966430664,103.48999786376952,92.6270673636704,-7.372932636329583,0.7050989644292684,-0.4382857525235957,0.07198155599095846,119716000.0,1.0
52,2023-03-20,GOOG,101.05999755859376,102.58000183105467,100.79000091552734,101.93000030517578,26033900.0,0.0,0.0,-0.529998779296875,0.529998779296875,0.0,74.23509716763957,89.7699966430664,103.48999786376952,88.62975641547509,-11.370243584524916,1.1223404432318347,-0.12616051337250953,0.08240418697161545,93682100.0,-1.0
53,2023-03-21,GOOG,101.9800033569336,105.95999908447266,101.86000061035156,105.83999633789062,33122800.0,0.0,0.0,3.9099960327148438,0.0,3.9099960327148438,80.90386913157819,89.7699966430664,105.95999908447266,99.25878487655369,-0.7412151234463181,1.7437150346798944,0.24781459623797142,0.1182249829013704,126804900.0,1.0
54,2023-03-22,GOOG,105.13999938964844,107.51000213623048,104.20999908447266,104.22000122070312,32336900.0,0.0,0.0,-1.6199951171875,1.6199951171875,0.0,71.99532108410389,89.94000244140625,107.51000213623048,81.2748948624255,-18.72510513757451,2.083043374352883,0.6148603518609539,0.12475714549664829,94468000.0,-1.0
55,2023-03-23,GOOG,105.88999938964844,107.10099792480467,105.41000366210938,106.26000213623048,31385800.0,0.0,0.0,2.040000915527358,0.0,2.040000915527358,75.85789906028202,89.94000244140625,107.51000213623048,92.88560033175057,-7.114399668249424,2.485767242547894,0.9890417299983421,0.16756400002246652,125853800.0,1.0
56,2023-03-24,GOOG,105.73999786376952,106.16000366210938,104.73999786376952,106.05999755859376,25236200.0,0.0,0.0,-0.20000457763671875,0.20000457763671875,0.0,74.6924828927082,89.94000244140625,107.51000213623048,91.74727033112094,-8.252729668879054,2.7570866215735776,1.3426507083133894,0.1571022618498661,100617600.0,-1.0
57,2023-03-27,GOOG,105.31999969482422,105.4000015258789,102.62999725341795,103.05999755859376,25393400.0,0.0,0.0,-3.0,3.0,0.0,59.00371577990706,89.94000244140625,107.51000213623048,74.67271112732233,-25.327288872677673,2.701396404171149,1.6143998474849417,0.09347477515749358,75224200.0,-1.0
58,2023-03-28,GOOG,103.0,103.0,100.27999877929688,101.36000061035156,24913500.0,0.0,0.0,-1.6999969482422017,1.6999969482422017,0.0,51.87884470784767,89.94000244140625,107.51000213623048,64.99714494764285,-35.00285505235715,2.4926682024022,1.790053518468394,0.049818719902217534,50310700.0,-1.0
59,2023-03-29,GOOG,102.72000122070312,102.81999969482422,101.02999877929688,101.9000015258789,26148300.0,0.0,0.0,0.5400009155273438,0.0,0.5400009155273438,53.91832793391838,89.94000244140625,107.51000213623048,68.07057081506855,-31.929429184931458,2.3433896594449806,1.9007207466637113,0.008212148348281767,76459000.0,1.0
60,2023-03-30,GOOG,101.44000244140624,101.61000061035156,100.29000091552734,101.31999969482422,25009800.0,0.0,0.0,-0.5800018310546875,0.5800018310546875,0.0,51.22759358353241,89.94000244140625,107.51000213623048,64.76947894751692,-35.23052105248308,2.1538311517532236,1.9513428276816138,-0.01112628733002985,51449200.0,-1.0
61,2023-03-31,GOOG,101.70999908447266,104.19000244140624,101.44000244140624,104.0,28108000.0,0.0,0.0,2.6800003051757812,0.0,2.6800003051757812,61.47717110596917,92.77999877929688,107.51000213623048,76.17107035771123,-23.828929642288767,2.192864151501297,1.9996470924455507,0.02030805149246251,79557200.0,1.0
62,2023-04-03,GOOG,102.66999816894533,104.9499969482422,102.37999725341795,104.91000366210938,20719900.0,0.0,0.0,0.910003662109375,0.0,0.910003662109375,64.4076877143207,93.04000091552734,107.51000213623048,82.03180197109364,-17.96819802890636,2.270487301483115,2.053815134253064,-0.00878677917573123,100277100.0,1.0
63,2023-04-04,GOOG,104.83999633789062,106.0999984741211,104.5999984741211,105.12000274658205,20377200.0,0.0,0.0,0.20999908447267046,0.0,0.20999908447267046,65.11432302994059,95.87000274658205,107.51000213623048,79.46735811881669,-20.532641881183316,2.322033961822953,2.1074588997670416,0.008635593123559993,120654300.0,1.0
64,2023-04-05,GOOG,106.12000274658205,106.54000091552734,104.10199737548828,104.9499969482422,21864200.0,0.0,0.0,-0.17000579833984375,0.17000579833984375,0.0,63.928746579679085,100.27999877929688,107.51000213623048,64.59192255376722,-35.408077446232774,2.322450539190271,2.1504572276516876,-0.012328300034370354,98790100.0,-1.0
65,2023-04-06,GOOG,105.7699966430664,109.62999725341795,104.81500244140624,108.9000015258789,34684200.0,0.0,0.0,3.9500045776367045,0.0,3.9500045776367045,75.76067123148377,100.27999877929688,109.62999725341795,92.19255778961323,-7.807442210386773,2.609563238525965,2.242278429826543,0.02677733389269754,133474300.0,1.0
66,2023-04-10,GOOG,107.38999938964844,107.97000122070312,105.5999984741211,106.9499969482422,19741500.0,0.0,0.0,-1.9500045776367045,1.9500045776367045,0.0,63.833701229304125,100.27999877929688,109.62999725341795,71.33689045411658,-28.663109545883415,2.65000550911887,2.3238238456850087,0.03774499788277996,113732800.0,-1.0
67,2023-04-11,GOOG,106.91999816894533,107.22000122070312,105.27999877929688,106.12000274658205,18721300.0,0.0,0.0,-0.8299942016601562,0.8299942016601562,0.0,59.2524906217148,100.27999877929688,109.62999725341795,62.4599456721745,-37.54005432782551,2.585583270457775,2.376175730639562,0.04696134675974295,95011500.0,-1.0
68,2023-04-12,GOOG,107.38999938964844,107.58699798583984,104.97000122070312,105.22000122070312,22761600.0,0.0,0.0,-0.9000015258789205,0.9000015258789205,0.0,54.37036888225618,100.27999877929688,109.62999725341795,52.83425933254626,-47.16574066745373,2.434160672166257,2.3877727189449014,0.03258095824445162,72249900.0,-1.0
69,2023-04-13,GOOG,106.47000122070312,108.26499938964844,106.44000244140624,108.19000244140624,21650700.0,0.0,0.0,2.970001220703111,0.0,2.970001220703111,65.26725459847064,100.27999877929688,109.62999725341795,84.59898345441087,-15.40101654558913,2.5236888189284343,2.414955938941608,0.06780500165095216,93900600.0,1.0
70,2023-04-14,GOOG,107.69000244140624,109.58000183105467,107.58999633789062,109.45999908447266,20758700.0,0.0,0.0,1.2699966430664205,0.0,1.2699966430664205,68.92836931003656,100.27999877929688,109.62999725341795,98.1818374685748,-1.8181625314252097,2.6659615147336666,2.46515705410002,0.05249999119685245,114659300.0,1.0
71,2023-04-17,GOOG,105.43000030517578,106.70999908447266,105.31999969482422,106.41999816894533,29043400.0,0.0,0.0,-3.0400009155273295,3.0400009155273295,0.0,53.385904933795956,100.27999877929688,109.62999725341795,65.66845338684,-34.33154661316001,2.5054007294937435,2.473205789178765,0.014393236623070571,85615900.0,-1.0
72,2023-04-18,GOOG,107.0,107.0500030517578,104.77999877929688,105.12000274658205,17641400.0,0.0,0.0,-1.2999954223632812,1.2999954223632812,0.0,48.040889851897866,100.29000091552734,109.62999725341795,51.71310197906922,-48.286898020930785,2.2476904153469945,2.428102714412411,0.0,67974500.0,-1.0
73,2023-04-19,GOOG,104.21499633789062,105.7249984741211,103.8000030517578,105.0199966430664,16732000.0,0.0,0.0,-0.10000610351563921,0.10000610351563921,0.0,47.617711506798166,100.29000091552734,109.62999725341795,50.642372399551796,-49.35762760044821,2.012208654527001,2.344923902435329,0.0006669813898014798,51242500.0,-1.0
74,2023-04-20,GOOG,104.6500015258789,106.88800048828124,104.63999938964844,105.9000015258789,22515300.0,0.0,0.0,0.8800048828125,0.0,0.8800048828125,51.918034601475824,101.44000244140624,109.62999725341795,54.45667777385509,-45.54332222614491,1.8747763755646503,2.2508943970611934,-0.027548208980392785,73757800.0,1.0
75,2023-04-21,GOOG,106.08999633789062,106.63999938964844,105.48500061035156,105.91000366210938,22379000.0,0.0,0.0,0.01000213623046875,0.0,0.01000213623046875,51.96974609618503,102.37999725341795,109.62999725341795,48.689743568157525,-51.31025643184247,1.7465268832309278,2.15002089429514,-0.009724107674693339,96136800.0,1.0
76,2023-04-24,GOOG,106.0500030517578,107.31999969482422,105.36000061035156,106.77999877929688,21410900.0,0.0,0.0,0.8699951171875,0.0,0.8699951171875,56.64899362787132,103.8000030517578,109.62999725341795,51.11490036629006,-48.885099633709935,1.6953675963060846,2.059090234697329,0.006219336747388837,117547700.0,1.0
77,2023-04-25,GOOG,106.61000061035156,107.44000244140624,104.55999755859376,104.61000061035156,31408100.0,0.0,0.0,-2.1699981689453125,2.1699981689453125,0.0,44.24378952574878,103.8000030517578,109.62999725341795,13.893625457862518,-86.10637454213747,1.463251395710813,1.939922466900026,-0.005797382657999228,86139600.0,-1.0
78,2023-04-26,GOOG,105.55999755859376,107.0199966430664,103.2699966430664,104.4499969482422,37068200.0,0.0,0.0,-0.1600036621093608,0.1600036621093608,0.0,43.434571188606206,103.2699966430664,109.62999725341795,18.55346213733415,-81.44653786266585,1.2519814332358408,1.8023342601671892,-0.03456886411653015,49071400.0,-1.0
79,2023-04-27,GOOG,105.2300033569336,109.1500015258789,104.41999816894533,108.37000274658205,38235200.0,0.0,0.0,3.9200057983398438,0.0,3.9200057983398438,62.71311405685348,103.2699966430664,109.58000183105467,80.82411902329362,-19.17588097670638,1.3842800994252116,1.7187234280187935,-0.009957942143316134,87306600.0,1.0
80,2023-04-28,GOOG,107.8000030517578,108.29000091552734,106.04000091552734,108.22000122070312,23957900.0,0.0,0.0,-0.15000152587892046,0.15000152587892046,0.0,61.78339493229403,103.2699966430664,109.58000183105467,78.4469177150528,-21.553082284947198,1.4602063634080196,1.6670200150966386,0.01691414285593429,63348700.0,-1.0
81,2023-05-01,GOOG,107.72000122070312,108.68000030517578,107.5,107.70999908447266,20926300.0,0.0,0.0,-0.5100021362304688,0.5100021362304688,0.0,58.387623709134665,103.2699966430664,109.58000183105467,70.36448163082724,-29.635518369172758,1.462431087999974,1.6261022296773056,0.02463847289021137,42422400.0,-1.0
82,2023-05-02,GOOG,107.66000366210938,107.7300033569336,104.5,105.9800033569336,20343100.0,0.0,0.0,-1.7299957275390625,1.7299957275390625,0.0,48.05077825407911,103.2699966430664,109.58000183105467,42.94777314963162,-57.05222685036837,1.3097142695478823,1.5628246376514212,0.009141180199519372,22079300.0,-1.0
83,2023-05-03,GOOG,106.22000122070312,108.12999725341795,105.62000274658205,106.12000274658205,17116300.0,0.0,0.0,0.1399993896484517,0.0,0.1399993896484517,48.89557981289208,103.2699966430664,109.58000183105467,45.1664621281281,-54.8335378718719,1.1862894811189904,1.4875176063449351,0.0020774430361965024,39195600.0,1.0
84,2023-05-04,GOOG,106.16000366210938,106.3000030517578,104.6999969482422,105.20999908447266,19780600.0,0.0,0.0,-0.9100036621093892,0.9100036621093892,0.0,43.58024928924849,103.2699966430664,109.1500015258789,32.9932114015238,-67.00678859847619,1.0035733107928877,1.3907287472345258,-0.006609428320576649,19415000.0,-1.0
85,2023-05-05,GOOG,105.31999969482422,106.44000244140624,104.73899841308594,106.21499633789062,20705300.0,0.0,0.0,1.0049972534179688,0.0,1.0049972534179688,50.4449031823952,103.2699966430664,109.1500015258789,50.084987232452406,-49.915012767547594,0.9290541893340389,1.2983938356544285,-0.0052912759680213695,40120300.0,1.0
86,2023-05-08,GOOG,105.79499816894533,108.41999816894533,105.79000091552734,108.23999786376952,17266000.0,0.0,0.0,2.025001525878892,0.0,2.025001525878892,61.371868615946255,103.2699966430664,109.1500015258789,84.52376009466646,-15.476239905333546,1.0214347135775057,1.243002011239044,0.0347002889995085,57386300.0,1.0
87,2023-05-09,GOOG,108.77999877929688,110.59500122070312,107.7249984741211,107.94000244140624,24782400.0,0.0,0.0,-0.29999542236328125,0.29999542236328125,0.0,59.14266712009571,103.2699966430664,110.59500122070312,63.7543055276359,-36.2456944723641,1.0582635089697305,1.2060543107851815,0.033413169891172156,32603900.0,-1.0
88,2023-05-10,GOOG,108.5500030517578,113.51000213623048,108.4800033569336,112.27999877929688,47533500.0,0.0,0.0,4.339996337890639,0.0,4.339996337890639,74.56465270804821,103.2699966430664,113.51000213623048,87.98825491104745,-12.011745088952557,1.4209253477347232,1.24902851817509,0.03608005844438478,80137400.0,1.0
89,2023-05-11,GOOG,115.86000061035156,118.44000244140624,114.93000030517578,116.9000015258789,57115100.0,0.0,0.0,4.620002746582031,0.0,4.620002746582031,82.62173086124805,103.2699966430664,118.44000244140624,89.84838281541155,-10.151617184588444,2.057074686386386,1.4106377518173494,0.08020698768496448,137252500.0,1.0
90,2023-05-12,GOOG,117.0,118.26000213623048,116.5500030517578,117.91999816894533,31272500.0,0.0,0.0,1.0199966430664205,0.0,1.0199966430664205,83.91935187186037,103.2699966430664,118.44000244140624,96.57215508435853,-3.4278449156414768,2.6133296950380895,1.6511761404614977,0.09479156226215713,168525000.0,1.0
91,2023-05-15,GOOG,116.48999786376952,118.79499816894533,116.4800033569336,116.95999908447266,22107900.0,0.0,0.0,-0.9599990844726705,0.9599990844726705,0.0,77.62484007824165,103.2699966430664,118.79499816894533,88.1803613261237,-11.8196386738763,2.9428309842569575,1.9095071092205897,0.10360441007497578,146417100.0,-1.0
92,2023-05-16,GOOG,116.83000183105467,121.1999969482422,116.83000183105467,120.08999633789062,32370100.0,0.0,0.0,3.1299972534179688,0.0,3.1299972534179688,82.54908086438816,104.41999816894533,121.1999969482422,93.38497800297165,-6.615021997028349,3.4169500462512303,2.210995696626718,0.13164335874236044,178787200.0,1.0
93,2023-05-17,GOOG,120.18000030517578,122.27999877929688,119.45999908447266,121.4800033569336,26659600.0,0.0,0.0,1.3900070190429688,0.0,1.3900070190429688,84.31758843655808,104.5,122.27999877929688,95.50058786677307,-4.499412133226917,3.8602732091815284,2.5408511991376805,0.15464313671743146,205446800.0,1.0
94,2023-05-18,GOOG,121.55999755859376,123.9000015258789,121.48999786376952,123.5199966430664,27014500.0,0.0,0.0,2.0399932861328125,0.0,2.0399932861328125,86.61467422416862,104.5,123.9000015258789,98.04121209833109,-1.9587879016689105,4.326240748841059,2.8979291090783565,0.16292426589297437,232461300.0,1.0
95,2023-05-19,GOOG,124.1999969482422,126.47899627685548,122.72000122070312,123.25,30251300.0,0.0,0.0,-0.26999664306640625,0.26999664306640625,0.0,84.71960182338682,104.5,126.47899627685548,85.30871821359874,-14.69128178640127,4.620479978839484,3.2424392830305826,0.13867334102428597,202210000.0,-1.0
96,2023-05-22,GOOG,123.51000213623048,127.0500030517578,123.4499969482422,125.87000274658205,29760200.0,0.0,0.0,2.6200027465820455,0.0,2.6200027465820455,87.72636277735198,104.6999969482422,127.0500030517578,94.72035801820142,-5.279641981798573,5.007239996111764,3.595399425646819,0.1661108013677215,231970200.0,1.0
97,2023-05-23,GOOG,124.93000030517578,125.41999816894533,123.0500030517578,123.29000091552734,24477900.0,0.0,0.0,-2.5800018310547017,2.5800018310547017,0.0,71.69654357140203,104.6999969482422,127.0500030517578,83.1767288169151,-16.823271183084895,5.047477267109798,3.885814993939415,0.09805844545716713,207492300.0,-1.0
98,2023-05-24,GOOG,121.87999725341795,122.75,120.75,121.63999938964844,23087900.0,0.0,0.0,-1.6500015258789062,1.6500015258789062,0.0,63.177805317956924,104.73899841308594,127.0500030517578,75.75185990176277,-24.248140098237233,4.889912598637039,4.0866345148789405,0.04054745767236123,184404400.0,-1.0
99,2023-05-25,GOOG,125.20999908447266,125.9800033569336,122.9000015258789,124.3499984741211,33812700.0,0.0,0.0,2.7099990844726562,0.0,2.7099990844726562,69.94522666747191,105.79000091552734,127.0500030517578,87.30007381779392,-12.699926182206086,4.926826839359492,4.254672979775051,0.05452849732887066,218217100.0,1.0
100,2023-05-26,GOOG,124.06500244140624,126.0,123.29000091552734,125.43000030517578,25154700.0,0.0,0.0,1.0800018310546875,0.0,1.0800018310546875,72.28727589791428,107.7249984741211,127.0500030517578,91.61706409913755,-8.382935900862439,4.985718671902234,4.400882118200488,0.07241793166042854,243371800.0,1.0
101,2023-05-30,GOOG,126.29000091552734,126.37999725341795,122.88999938964844,124.63999938964844,27230700.0,0.0,0.0,-0.7900009155273438,0.7900009155273438,0.0,67.82628243920252,108.4800033569336,127.0500030517578,87.02205868758807,-12.977941312411936,4.912040920580807,4.503113878676552,0.037888277046455476,216141100.0,-1.0
102,2023-05-31,GOOG,123.6999969482422,124.9000015258789,123.0999984741211,123.37000274658205,41548800.0,0.0,0.0,-1.269996643066392,1.269996643066392,0.0,60.85966201293381,114.93000030517578,127.0500030517578,69.63696805915694,-30.36303194084305,4.697059392530761,4.541902981447394,0.015558111108173511,174592300.0,-1.0
103,2023-06-01,GOOG,123.5,125.04000091552734,123.3000030517578,124.37000274658205,25017700.0,0.0,0.0,1.0,0.0,1.0,64.20043677817318,116.4800033569336,127.0500030517578,74.64521870811345,-25.354781291886553,4.554844132337081,4.544491211625331,0.006881526284135964,199610000.0,1.0
104,2023-06-02,GOOG,124.48999786376952,126.74500274658205,124.3499984741211,125.2300033569336,19362400.0,0.0,0.0,0.8600006103515483,0.0,0.8600006103515483,66.9958015098373,116.4800033569336,127.0500030517578,82.78145934369893,-17.21854065630107,4.460097179431614,4.527612405186588,0.016064935958893356,218972400.0,1.0
105,2023-06-05,GOOG,124.61000061035156,127.98999786376952,124.37999725341795,126.62999725341795,22672500.0,0.0,0.0,1.3999938964843608,0.0,1.3999938964843608,71.21730793356878,116.83000183105467,127.98999786376952,87.81361027042658,-12.186389729573417,4.446686686912599,4.51142726153179,0.006037931915883421,241644900.0,1.0
106,2023-06-06,GOOG,126.5999984741211,128.8800048828125,125.97000122070312,127.91000366210938,19450100.0,0.0,0.0,1.2800064086914205,0.0,1.2800064086914205,74.63940005141492,119.45999908447266,128.8800048828125,89.7027534646096,-10.297246535390407,4.487587020161229,4.506659213257678,0.03747264751622037,261095000.0,1.0
107,2023-06-07,GOOG,127.5749969482422,129.5500030517578,122.62999725341795,122.94000244140624,34179300.0,0.0,0.0,-4.970001220703139,4.970001220703139,0.0,48.69915913643928,120.75,129.5500030517578,24.886382749251204,-75.1136172507488,4.072111948959645,4.419749760398072,0.010687299065116784,226915700.0,-1.0
108,2023-06-08,GOOG,122.58499908447266,123.7300033569336,122.01000213623048,122.66999816894533,24815000.0,0.0,0.0,-0.2700042724609091,0.2700042724609091,0.0,47.660842931660746,120.75,129.5500030517578,21.818153444410505,-78.1818465555895,3.6786565052094318,4.271531109360344,-0.013510255937199678,202100700.0,-1.0
109,2023-06-09,GOOG,122.55999755859376,124.28500366210938,122.41999816894533,122.87000274658205,20304500.0,0.0,0.0,0.20000457763671875,0.0,0.20000457763671875,48.59756143338126,120.75,129.5500030517578,24.0909319475585,-75.90906805244151,3.344422794247592,4.086109446337794,-0.020409770807344074,222405200.0,1.0
110,2023-06-12,GOOG,123.3949966430664,124.75,122.3499984741211,124.3499984741211,22255700.0,0.0,0.0,1.4799957275390483,0.0,1.4799957275390483,55.41116596459666,120.75,129.5500030517578,40.90905938267816,-59.09094061732184,3.162486150871871,3.9013847872446092,-0.002326708255355081,244660900.0,1.0
111,2023-06-13,GOOG,125.6500015258789,125.86000061035156,123.84500122070312,124.43000030517578,19287700.0,0.0,0.0,0.0800018310546875,0.0,0.0800018310546875,55.77678674199372,120.75,129.5500030517578,41.81817078393736,-58.18182921606264,2.9902836385712135,3.71916455750993,0.00859202022367711,263948600.0,1.0
112,2023-06-14,GOOG,123.8000030517578,124.79000091552734,122.16000366210938,124.37999725341795,24659600.0,0.0,0.0,-0.05000305175782671,0.05000305175782671,0.0,55.44888624915225,122.01000213623048,129.5500030517578,31.43229216732422,-68.56770783267578,2.817301017157078,3.53879184943936,8.036107272801907e-05,239289000.0,-1.0
113,2023-06-15,GOOG,123.87999725341795,126.16000366210938,123.13999938964844,125.79000091552734,24517100.0,0.0,0.0,1.4100036621093892,0.0,1.4100036621093892,62.602186110779805,122.01000213623048,129.5500030517578,50.132603717760915,-49.86739628223909,2.7621295883369896,3.383459397218886,0.004471752324382239,263806100.0,1.0
114,2023-06-16,GOOG,126.6999969482422,126.6999969482422,123.79000091552734,124.05999755859376,56686800.0,0.0,0.0,-1.7300033569335795,1.7300033569335795,0.0,51.0075539609637,122.01000213623048,129.5500030517578,27.188264899831378,-72.81173510016863,2.5494386424300615,3.216655246261121,-0.020295346683779747,207119300.0,-1.0
115,2023-06-20,GOOG,123.53500366210938,125.1750030517578,122.83000183105467,123.8499984741211,22698000.0,0.0,0.0,-0.20999908447267046,0.20999908447267046,0.0,49.71782642696653,122.01000213623048,129.5500030517578,24.40313149168797,-75.59686850831203,2.336996690190432,3.0407235350469835,-0.03174110758931181,184421300.0,-1.0
116,2023-06-21,GOOG,123.23500061035156,123.41000366210938,120.86000061035156,121.26000213623048,22612000.0,0.0,0.0,-2.589996337890611,2.589996337890611,0.0,36.561889982273975,120.86000061035156,129.5500030517578,4.603008210595976,-95.39699178940403,1.937335055462185,2.820045839130024,-0.013665204748767201,161809300.0,-1.0
117,2023-06-22,GOOG,120.66000366210938,123.93499755859376,119.5999984741211,123.87000274658205,20781900.0,0.0,0.0,2.6100006103515625,0.0,2.6100006103515625,51.48804046930638,119.5999984741211,129.5500030517578,42.914596060167284,-57.085403939832716,1.8103151836562006,2.6180997080352597,0.009782380333812624,182591200.0,1.0
118,2023-06-23,GOOG,122.04000091552734,123.44000244140624,121.86000061035156,123.0199966430664,29542900.0,0.0,0.0,-0.8500061035156392,0.8500061035156392,0.0,47.30551409036682,119.5999984741211,129.5500030517578,34.371825080683685,-65.62817491931632,1.6223674936969843,2.418953265167605,0.0012207527722916112,153048300.0,-1.0
119,2023-06-26,GOOG,121.46600341796876,122.72000122070312,118.98999786376952,119.08999633789062,23185000.0,0.0,0.0,-3.9300003051757812,3.9300003051757812,0.0,33.00318824659624,118.98999786376952,129.5500030517578,0.9469547821326203,-99.05304521786738,1.1431505092110967,2.1637927139763034,-0.04229997748914449,129863300.0,-1.0
120,2023-06-27,GOOG,117.83999633789062,119.8949966430664,116.91000366210938,119.01000213623048,27221700.0,0.0,0.0,-0.07999420166014204,0.07999420166014204,0.0,32.77049076762823,116.91000366210938,129.5500030517578,16.613912781047343,-83.38608721895265,0.7482877145800586,1.8806917140970543,-0.04355861251830162,102641600.0,-1.0
121,2023-06-28,GOOG,117.95999908447266,121.2699966430664,117.5999984741211,121.08000183105467,19753100.0,0.0,0.0,2.0699996948241903,0.0,2.0699996948241903,44.46233626935954,116.91000366210938,126.6999969482422,42.59449467500607,-57.40550532499393,0.595510345971789,1.6236554404720012,-0.026531560501964813,122394700.0,1.0
122,2023-06-29,GOOG,120.08999633789062,120.91000366210938,119.20999908447266,120.01000213623048,18517500.0,0.0,0.0,-1.0699996948241903,1.0699996948241903,0.0,40.28388140931199,116.91000366210938,126.6999969482422,31.66497037860224,-68.33502962139775,0.3836766033158625,1.3756596730407735,-0.04594958849851938,103877200.0,-1.0
123,2023-06-30,GOOG,121.0999984741211,122.02999877929688,120.87999725341795,120.97000122070312,23865800.0,0.0,0.0,0.959999084472642,0.0,0.959999084472642,45.57843706424204,116.91000366210938,126.6999969482422,41.47089216439597,-58.52910783560403,0.2899137349859586,1.1585104854298105,-0.02490727388924241,127743000.0,1.0
124,2023-07-03,GOOG,120.31999969482422,121.0199966430664,119.70500183105467,120.55999755859376,13888300.0,0.0,0.0,-0.4100036621093608,0.4100036621093608,0.0,43.67038681237122,116.91000366210938,126.6999969482422,37.2829050011145,-62.7170949988855,0.1804441351154935,0.9628972153669471,-0.026564400129684196,113854700.0,-1.0
125,2023-07-05,GOOG,120.05999755859376,123.37000274658205,120.05999755859376,122.62999725341795,17830300.0,0.0,0.0,2.0699996948241903,0.0,2.0699996948241903,54.71427819059824,116.91000366210938,126.6999969482422,58.42694089903764,-41.57305910096236,0.25773981215161257,0.8218657347238802,0.01129799680894239,131685000.0,1.0
126,2023-07-06,GOOG,120.63999938964844,121.1500015258789,119.25,120.93000030517578,17732500.0,0.0,0.0,-1.6999969482421733,1.6999969482421733,0.0,46.1418121827889,116.91000366210938,126.6999969482422,41.06230234867052,-58.93769765132948,0.17975670481295936,0.6934439287416961,-0.02373457960940739,113952500.0,-1.0
127,2023-07-07,GOOG,120.88999938964844,121.75,120.08999633789062,120.13999938964844,20982400.0,0.0,0.0,-0.7900009155273438,0.7900009155273438,0.0,42.56584354353515,116.91000366210938,126.6999969482422,32.99282883180559,-67.00717116819442,0.05359340950541025,0.565473824894439,-0.023410805820244573,92970100.0,-1.0
128,2023-07-10,GOOG,119.06999969482422,119.06999969482422,116.63999938964844,116.87000274658205,32960100.0,0.0,0.0,-3.269996643066392,3.269996643066392,0.0,31.066771469815862,116.63999938964844,125.1750030517578,2.6948243496917774,-97.30517565030821,-0.3067057888997198,0.3910379021356072,-0.01864131043391637,60010000.0,-1.0
129,2023-07-11,GOOG,116.76000213623048,118.2249984741211,115.83000183105467,117.70999908447266,18286600.0,0.0,0.0,0.8399963378906108,0.0,0.8399963378906108,36.17717906740406,115.83000183105467,123.93499755859376,23.195536637115588,-76.8044633628844,-0.5184906407826162,0.2091321935519625,-0.010923477257564596,78296600.0,1.0
130,2023-07-12,GOOG,119.3000030517578,120.95999908447266,119.0,119.62000274658205,22059600.0,0.0,0.0,1.9100036621093892,0.0,1.9100036621093892,46.56966673363498,115.83000183105467,123.93499755859376,46.76129442795061,-53.23870557204938,-0.5261510506386315,0.06207554471384365,-0.012058135632586064,100356200.0,1.0
131,2023-07-13,GOOG,121.54000091552734,125.33499908447266,121.05999755859376,124.83000183105467,31535900.0,0.0,0.0,5.209999084472628,0.0,5.209999084472628,64.67418755036466,115.83000183105467,125.33499908447266,94.68703419944296,-5.312965800557035,-0.1105592201834753,0.02754859173437985,0.04016331646551197,131892100.0,1.0
132,2023-07-14,GOOG,125.12999725341795,127.08999633789062,124.9000015258789,125.6999969482422,20482800.0,0.0,0.0,0.8699951171875284,0.0,0.8699951171875284,66.83915707764574,115.83000183105467,127.08999633789062,87.6554168050033,-12.344583194996707,0.28570572302687935,0.07918001799287977,0.039100567742488934,152374900.0,1.0
133,2023-07-17,GOOG,126.05999755859376,127.27999877929688,124.5,125.05999755859376,20675300.0,0.0,0.0,-0.6399993896484375,0.6399993896484375,0.0,63.53411303109144,115.83000183105467,127.27999877929688,80.61133788298585,-19.38866211701414,0.5418611548287231,0.17171624536004848,0.03732581362912635,131699600.0,-1.0
134,2023-07-18,GOOG,124.90499877929688,124.98999786376952,123.3000030517578,124.08000183105467,21071200.0,0.0,0.0,-0.9799957275390909,0.9799957275390909,0.0,58.42941177440815,115.83000183105467,127.27999877929688,72.05242095078931,-27.947579049210695,0.658203507702197,0.2690136978284782,0.011824224171189002,110628400.0,-1.0
135,2023-07-19,GOOG,124.79000091552734,125.47000122070312,122.47000122070312,122.77999877929688,22313800.0,0.0,0.0,-1.3000030517577983,1.3000030517577983,0.0,52.03071867714322,115.83000183105467,127.27999877929688,60.69867948138765,-39.30132051861235,0.6381527596822991,0.3428415101992424,0.015298093686037184,88314600.0,-1.0
136,2023-07-20,GOOG,122.12000274658205,124.6999969482422,118.68499755859376,119.52999877929688,27541700.0,0.0,0.0,-3.25,3.25,0.0,39.540089608475,115.83000183105467,127.27999877929688,32.31439244016762,-67.68560755983238,0.35591815081696154,0.3454568383227863,-0.005077414794827484,60772900.0,-1.0
137,2023-07-21,GOOG,120.87000274658205,121.3000030517578,119.06999969482422,120.30999755859376,56498100.0,0.0,0.0,0.7799987792968892,0.0,0.7799987792968892,43.308847522135736,115.83000183105467,127.27999877929688,39.126610668895054,-60.87338933110495,0.1929588872153829,0.31495724810130565,0.029434369223648504,117271000.0,1.0
138,2023-07-24,GOOG,121.9260025024414,123.3499984741211,121.37999725341795,121.87999725341795,22276100.0,0.0,0.0,1.5699996948241903,0.0,1.5699996948241903,50.478211291903726,115.83000183105467,127.27999877929688,52.83840205120818,-47.16159794879182,0.18832482886618607,0.28963076425428175,0.03542603178471504,139547100.0,1.0
139,2023-07-25,GOOG,121.87999725341795,123.69000244140624,121.52999877929688,122.79000091552734,31820800.0,0.0,0.0,0.9100036621093892,0.0,0.9100036621093892,54.340034504839025,115.83000183105467,127.27999877929688,60.78603440624642,-39.21396559375358,0.25513947276803606,0.28273250595703264,0.026500569270684782,171367900.0,1.0
140,2023-07-26,GOOG,130.36000061035156,131.3699951171875,128.7100067138672,129.66000366210938,46216900.0,0.0,0.0,6.870002746582031,0.0,6.870002746582031,72.8100219501901,115.83000183105467,131.3699951171875,88.99618922870422,-11.00381077129578,0.8526040821725474,0.3967068212001356,0.0386926360667017,217584800.0,1.0
141,2023-07-27,GOOG,131.8000030517578,133.60000610351562,129.17999267578125,129.8699951171875,35931600.0,0.0,0.0,0.209991455078125,0.0,0.209991455078125,73.19247693741426,115.83000183105467,133.60000610351562,79.00950990704764,-20.99049009295235,1.3277378972135097,0.5829130364028104,0.033174210582219255,253516400.0,1.0
142,2023-07-28,GOOG,130.97000122070312,134.07000732421875,130.9199981689453,133.00999450683594,26971000.0,0.0,0.0,3.1399993896484375,0.0,3.1399993896484375,78.42778322493731,115.83000183105467,134.07000732421875,94.1885279706737,-5.811472029326308,1.9353431241318475,0.8533990539486179,0.06356946348505566,280487400.0,1.0
143,2023-07-31,GOOG,133.00999450683594,133.8300018310547,132.1300048828125,133.11000061035156,18381900.0,0.0,0.0,0.100006103515625,0.0,0.100006103515625,78.58149931268585,118.68499755859376,134.07000732421875,93.760116317819,-6.239883682181004,2.39730935390736,1.1621811139403666,0.07277561771470631,298869300.0,1.0
144,2023-08-01,GOOG,130.85499572753906,132.9199981689453,130.75,131.88999938964844,22154300.0,0.0,0.0,-1.220001220703125,1.220001220703125,0.0,71.41816980290547,118.68499755859376,134.07000732421875,85.83031166193248,-14.169688338067518,2.6346080739749738,1.4566665059472883,0.07419775778567361,276715000.0,-1.0
145,2023-08-02,GOOG,129.83999633789062,130.4199981689453,127.8499984741211,128.63999938964844,22705800.0,0.0,0.0,-3.25,3.25,0.0,55.7867990576204,118.68499755859376,134.07000732421875,64.70585318247454,-35.294146817525466,2.5312456766313716,1.6715823400841052,0.07621518199102884,254009200.0,-1.0
146,2023-08-03,GOOG,128.3699951171875,129.77000427246094,127.7750015258789,128.77000427246094,15018100.0,0.0,0.0,0.1300048828125,0.0,0.1300048828125,56.22897919702911,118.68499755859376,134.07000732421875,65.55086325912052,-34.449136740879474,2.4317882377638824,1.823623519620061,0.07031840150895974,269027300.0,1.0
147,2023-08-04,GOOG,129.60000610351562,131.92999267578125,128.31500244140625,128.5399932861328,20509500.0,0.0,0.0,-0.230010986328125,0.230010986328125,0.0,55.10394229517055,118.68499755859376,134.07000732421875,64.05583017281047,-35.94416982718952,2.3078047575579177,1.9204597672076325,0.05464388072529336,248517800.0,-1.0
148,2023-08-07,GOOG,129.50999450683594,132.05999755859375,129.42999267578125,131.94000244140625,17621000.0,0.0,0.0,3.4000091552734375,0.0,3.4000091552734375,66.5269656487696,118.68499755859376,134.07000732421875,86.1553231667645,-13.84467683323549,2.455590069749192,2.0274858277159447,0.07451748072038544,266138800.0,1.0
149,2023-08-08,GOOG,130.97999572753906,131.94000244140625,130.1300048828125,131.83999633789062,16836000.0,0.0,0.0,-0.100006103515625,0.100006103515625,0.0,65.95741700311663,118.68499755859376,134.07000732421875,85.50530015710045,-14.494699842899546,2.5354146728551967,2.129071596743795,0.01681314680093826,249302800.0,-1.0
150,2023-08-09,GOOG,132.19000244140625,132.47000122070312,129.5050048828125,130.14999389648438,17745200.0,0.0,0.0,-1.69000244140625,1.69000244140625,0.0,56.52203235092544,119.06999969482422,134.07000732421875,73.86659044057696,-26.133409559423036,2.434247769665177,2.1901068313280714,0.00215599283763912,231557600.0,-1.0
151,2023-08-10,GOOG,131.97000122070312,132.64700317382812,130.03500366210938,130.2100067138672,17855700.0,0.0,0.0,0.0600128173828125,0.0,0.0600128173828125,56.775388621730066,121.37999725341795,134.07000732421875,69.58236763552088,-30.417632364479118,2.3320325189918094,2.218491968860819,-0.0210509578874154,249413300.0,1.0
152,2023-08-11,GOOG,129.20199584960938,130.44000244140625,128.75,130.1699981689453,15191500.0,0.0,0.0,-0.040008544921875,0.040008544921875,0.0,56.52202934139422,121.52999877929688,134.07000732421875,68.89946971485308,-31.100530285146906,2.2221819106925977,2.2192299572271748,-0.022087013957819868,234221800.0,-1.0
153,2023-08-14,GOOG,129.85000610351562,131.91000366210938,129.58999633789062,131.8300018310547,17526200.0,0.0,0.0,1.660003662109375,0.0,1.660003662109375,64.17553794868769,127.7750015258789,134.07000732421875,64.41614885001678,-35.58385114998322,2.2432136575463204,2.224026697291004,-0.0004549060495215862,251748000.0,1.0
154,2023-08-15,GOOG,131.58999633789062,131.99000549316406,129.81900024414062,130.27000427246094,14769200.0,0.0,0.0,-1.55999755859375,1.55999755859375,0.0,53.889298708443064,127.7750015258789,134.07000732421875,39.63463778286,-60.36536221714,2.109684319218047,2.2011582216764127,0.012671057917803985,236978800.0,-1.0
155,2023-08-16,GOOG,129.27999877929688,130.8979949951172,128.4600067138672,129.11000061035156,17548400.0,0.0,0.0,-1.160003662109375,1.160003662109375,0.0,47.374314195949744,127.7750015258789,134.07000732421875,21.207273309021097,-78.7927266909789,1.8884899353794538,2.138624564417021,0.0026403380182487,219430400.0,-1.0
156,2023-08-17,GOOG,130.4499969482422,132.49099731445312,129.85000610351562,130.4600067138672,23665600.0,0.0,0.0,1.350006103515625,0.0,1.350006103515625,54.724501043124064,127.7750015258789,133.8300018310547,44.343601200038805,-55.656398799961195,1.8013604618474517,2.071171743903107,0.01493708983989439,243096000.0,1.0
157,2023-08-18,GOOG,129.05999755859375,129.8300018310547,127.0,128.11000061035156,23619400.0,0.0,0.0,-2.350006103515625,2.350006103515625,0.0,42.73576801921133,127.0,132.9199981689453,18.750016109368435,-81.24998389063155,1.525104330211235,1.9619582611647328,-0.029028359558774253,219476600.0,-1.0
158,2023-08-21,GOOG,127.8499984741211,129.25999450683594,127.16000366210938,128.92999267578125,21851100.0,0.0,0.0,0.8199920654296875,0.0,0.8199920654296875,47.37721971444658,127.0,132.64700317382812,34.17729043833529,-65.82270956166471,1.3566964126086418,1.8409058914535148,-0.022072237127884753,241327700.0,1.0
159,2023-08-22,GOOG,129.1300048828125,130.9499969482422,128.9250030517578,129.69000244140625,15569400.0,0.0,0.0,0.760009765625,0.0,0.760009765625,51.5748020959644,127.0,132.64700317382812,47.6359293345799,-52.364070665420094,1.269919263211733,1.7267085658051584,-0.0035343179150970627,256897100.0,1.0
160,2023-08-23,GOOG,130.85000610351562,134.07000732421875,130.50999450683594,133.2100067138672,26497000.0,0.0,0.0,3.5200042724609375,0.0,3.5200042724609375,66.0479585169985,127.0,134.07000732421875,87.83593041826737,-12.164069581732637,1.4682564257472563,1.675018137793578,0.023039703903805275,283394100.0,1.0
161,2023-08-24,GOOG,134.7270050048828,134.97000122070312,130.3000030517578,130.4199981689453,18680400.0,0.0,0.0,-2.790008544921875,2.790008544921875,0.0,51.869880839667,127.0,134.97000122070312,42.910886388090105,-57.089113611909895,1.384352516860588,1.61688501360698,0.0019205654414740092,264713700.0,-1.0
162,2023-08-25,GOOG,130.13999938964844,131.39999389648438,128.0399932861328,130.69000244140625,20678100.0,0.0,0.0,0.2700042724609375,0.0,0.2700042724609375,52.99656087302011,127.0,134.97000122070312,46.29864336558674,-53.70135663441326,1.324378464456828,1.5583837037769497,-0.008647495818966844,285391800.0,1.0
163,2023-08-28,GOOG,132.0800018310547,133.24000549316406,130.85000610351562,131.7899932861328,16715500.0,0.0,0.0,1.0999908447265625,0.0,1.0999908447265625,57.65607964852642,127.0,134.97000122070312,60.1002829672118,-39.8997170327882,1.3500458975576066,1.5167161425330813,0.011667989282419855,302107300.0,1.0
164,2023-08-29,GOOG,132.9980010986328,137.2949981689453,132.97999572753906,135.49000549316406,30803300.0,0.0,0.0,3.70001220703125,0.0,3.70001220703125,69.42115085910211,127.0,137.2949981689453,82.46728512078828,-17.53271487921173,1.6499273950223312,1.5433583930309314,0.049415264910942724,332910600.0,1.0
165,2023-08-30,GOOG,135.57000732421875,137.25,135.02099609375,136.92999267578125,21773400.0,0.0,0.0,1.4399871826171875,0.0,1.4399871826171875,72.81321964783572,127.0,137.2949981689453,96.45453561842201,-3.545464381577992,1.980945149322764,1.630875744289298,0.04959363505249881,354684000.0,1.0
166,2023-08-31,GOOG,137.0500030517578,138.39999389648438,136.82000732421875,137.35000610351562,28147900.0,0.0,0.0,0.420013427734375,0.0,0.420013427734375,73.79166245126497,127.0,138.39999389648438,90.78957583220676,-9.21042416779323,2.25121991619784,1.7549445786710065,0.07212555966858258,382831900.0,1.0
167,2023-09-01,GOOG,138.42999267578125,138.5800018310547,135.94000244140625,136.8000030517578,16665700.0,0.0,0.0,-0.5500030517578125,0.5500030517578125,0.0,69.98593016211655,127.0,138.5800018310547,84.62868309292179,-15.371316907078207,2.3934439189637544,1.8826444467295562,0.06104095883854721,366166200.0,-1.0
168,2023-09-05,GOOG,136.44000244140625,137.3699951171875,135.55999755859375,136.7100067138672,17730200.0,0.0,0.0,-0.089996337890625,0.089996337890625,0.0,69.3110278365991,127.0,138.5800018310547,83.85151276770408,-16.14848723229592,2.470418074402488,2.000199172264143,0.05412910895450529,348436000.0,-1.0
169,2023-09-06,GOOG,137.01499938964844,137.47999572753906,134.69000244140625,135.3699951171875,15814300.0,0.0,0.0,-1.3400115966796875,1.3400115966796875,0.0,59.45989939433755,127.0,138.5800018310547,72.279739151174,-27.720260848826012,2.3956772326562543,2.079294784342565,0.016214911001092736,332621700.0,-1.0
170,2023-09-07,GOOG,134.60000610351562,136.5800018310547,133.9600067138672,136.1999969482422,16976000.0,0.0,0.0,0.8300018310546875,0.0,0.8300018310546875,63.198175639766184,127.0,138.5800018310547,79.44728405456794,-20.55271594543205,2.376029275369092,2.1386416825478705,0.04431834734278639,349597700.0,1.0
171,2023-09-08,GOOG,135.8699951171875,137.51499938964844,135.8699951171875,137.1999969482422,17810700.0,0.0,0.0,1.0,0.0,1.0,67.37977463186597,127.16000366210938,138.5800018310547,87.91589225850156,-12.084107741498434,2.4133302606720406,2.1935793981727048,0.04981249051360792,367408400.0,1.0
172,2023-09-11,GOOG,137.3800048828125,138.26400756835938,136.5500030517578,137.74000549316406,17180800.0,0.0,0.0,0.540008544921875,0.0,0.540008544921875,69.5365302605571,128.0399932861328,138.5800018310547,92.03040173724213,-7.969598262757873,2.4581298714350908,2.246489492825182,0.04514767820128052,384589200.0,1.0
173,2023-09-12,GOOG,137.1300048828125,137.63999938964844,135.92999267578125,136.07000732421875,15212900.0,0.0,0.0,-1.6699981689453125,1.6699981689453125,0.0,56.262661356868044,128.0399932861328,138.5800018310547,76.18602967788635,-23.813970322113644,2.331997360344957,2.263591066329137,0.004280772068342431,369376300.0,-1.0
174,2023-09-13,GOOG,135.89999389648438,137.6999969482422,134.92999267578125,137.5,16394900.0,0.0,0.0,1.42999267578125,0.0,1.42999267578125,63.20275777583684,128.0399932861328,138.5800018310547,89.75331161780673,-10.246688382193268,2.3206734597932837,2.2750075450219667,0.004162764585611267,385771200.0,1.0
175,2023-09-14,GOOG,138.38999938964844,139.5500030517578,137.05999755859375,138.99000549316406,19064600.0,0.0,0.0,1.4900054931640625,0.0,1.4900054931640625,69.09800054873799,128.0399932861328,139.5500030517578,95.13469084738573,-4.865309152614275,2.404215724061686,2.3008491808299105,0.011940293533095447,404835800.0,1.0
176,2023-09-15,GOOG,138.8000030517578,139.36000061035156,137.17999267578125,138.3000030517578,48947600.0,0.0,0.0,-0.69000244140625,0.69000244140625,0.0,63.64932566965471,130.85000610351562,139.5500030517578,85.63217886814823,-14.367821131851768,2.387227721445072,2.318124888952943,0.01096491203609462,355888200.0,-1.0
177,2023-09-18,GOOG,137.6300048828125,139.92999267578125,137.6300048828125,138.9600067138672,16233600.0,0.0,0.0,0.660003662109375,0.0,0.660003662109375,66.5596405232053,132.97999572753906,139.92999267578125,86.04336132608815,-13.95663867391185,2.3993629638765412,2.334372503937663,0.01645819537343174,372121800.0,1.0
178,2023-09-19,GOOG,138.25,139.1750030517578,137.5,138.8300018310547,15479100.0,0.0,0.0,-0.1300048828125,0.1300048828125,0.0,65.37013056514931,133.9600067138672,139.92999267578125,81.57464939207513,-18.425350607924877,2.3711567104769813,2.341729345245527,0.025559627972741916,356642700.0,-1.0
179,2023-09-20,GOOG,138.8300018310547,138.83999633789062,134.52000427246094,134.58999633789062,21473500.0,0.0,0.0,-4.2400054931640625,4.2400054931640625,0.0,39.084574656560136,133.9600067138672,139.92999267578125,10.552614830964425,-89.44738516903557,1.9838023075053854,2.270143937697499,-0.011820856434845428,335169200.0,-1.0
180,2023-09-21,GOOG,132.38999938964844,133.19000244140625,131.08999633789062,131.36000061035156,22042700.0,0.0,0.0,-3.2299957275390625,3.2299957275390625,0.0,28.877855099000655,131.08999633789062,139.92999267578125,3.054348238851931,-96.94565176114807,1.4000488162230056,2.0961249134026003,-0.04256557192267085,313126500.0,-1.0
181,2023-09-22,GOOG,131.67999267578125,133.00999450683594,130.50999450683594,131.25,17348700.0,0.0,0.0,-0.1100006103515625,0.1100006103515625,0.0,28.584527542620037,130.50999450683594,139.92999267578125,7.855686167791638,-92.14431383220835,0.9179621518642591,1.860492361094932,-0.047117796096546205,295777800.0,-1.0
182,2023-09-25,GOOG,130.77000427246094,132.22000122070312,130.02999877929688,132.1699981689453,14650000.0,0.0,0.0,0.9199981689453125,0.0,0.9199981689453125,34.95994471589117,130.02999877929688,139.92999267578125,21.616168777724003,-78.383831222276,0.6031879351612588,1.6090314759081976,-0.02866178397404473,310427800.0,1.0
183,2023-09-26,GOOG,130.91400146484375,131.40499877929688,128.19000244140625,129.4499969482422,20378800.0,0.0,0.0,-2.720001220703125,2.720001220703125,0.0,26.798647225998522,128.19000244140625,139.92999267578125,10.732500467901927,-89.26749953209807,0.13271601219662443,1.313768383165883,-0.058545476740056834,290049000.0,-1.0
184,2023-09-27,GOOG,129.44000244140625,131.72000122070312,129.3800048828125,131.4600067138672,18764200.0,0.0,0.0,2.010009765625,0.0,2.010009765625,38.95061805616846,128.19000244140625,139.92999267578125,27.8535518955227,-72.1464481044773,-0.07705721490015094,1.0356032635526762,-0.05417654854087495,308813200.0,1.0
185,2023-09-28,GOOG,130.69000244140625,134.17999267578125,130.69000244140625,133.1300048828125,18201400.0,0.0,0.0,1.6699981689453125,0.0,1.6699981689453125,47.332408590297646,128.19000244140625,139.92999267578125,42.078420363091894,-57.921579636908106,-0.1073121600981608,0.8070201788225088,-0.0373824877430442,327014600.0,1.0
186,2023-09-29,GOOG,134.0800018310547,134.88999938964844,131.32000732421875,131.85000610351562,23224200.0,0.0,0.0,-1.279998779296875,1.279998779296875,0.0,42.20749468989829,128.19000244140625,139.92999267578125,31.175525609832178,-68.82447439016782,-0.23190135756803443,0.5992358715444002,-0.05116580502900936,303790400.0,-1.0
187,2023-10-02,GOOG,132.15499877929688,135.36000061035156,132.06500244140625,135.1699981689453,19210400.0,0.0,0.0,3.3199920654296875,0.0,3.3199920654296875,56.35150685309942,128.19000244140625,139.92999267578125,59.45486825961278,-40.54513174038721,-0.06202868142364082,0.46698296095079195,-0.026363204018129416,323000800.0,1.0
188,2023-10-03,GOOG,134.92999267578125,135.24000549316406,132.81500244140625,133.3000030517578,19628700.0,0.0,0.0,-1.8699951171875,1.8699951171875,0.0,48.61841406692091,128.19000244140625,139.92999267578125,43.52644685673883,-56.47355314326117,-0.07740400747215403,0.35810556726620274,-0.009584614913683898,303372100.0,-1.0
189,2023-10-04,GOOG,133.66000366210938,136.57000732421875,133.42999267578125,136.27000427246094,22848000.0,0.0,0.0,2.970001220703125,0.0,2.970001220703125,58.94349996821682,128.19000244140625,139.92999267578125,68.82460436292554,-31.17539563707447,0.14835497012853693,0.3161554478386696,0.037378225025087586,326220100.0,1.0
190,2023-10-05,GOOG,136.1300048828125,136.5,134.4550018310547,135.99000549316406,15922900.0,0.0,0.0,-0.279998779296875,0.279998779296875,0.0,57.68260630942744,128.19000244140625,139.92999267578125,66.43960425894733,-33.56039574105267,0.30120492966969437,0.3131653442048746,0.0361143275669642,310297200.0,-1.0
191,2023-10-06,GOOG,134.94000244140625,139.18600463867188,134.94000244140625,138.72999572753906,20819300.0,0.0,0.0,2.739990234375,0.0,2.739990234375,65.915312872609,128.19000244140625,139.18600463867188,95.85295725708195,-4.147042742918042,0.636101277827521,0.3777525309294039,0.04963303056271884,331116500.0,1.0
192,2023-10-09,GOOG,137.99000549316406,139.97000122070312,136.6999969482422,139.5,16599100.0,0.0,0.0,0.7700042724609375,0.0,0.7700042724609375,67.93790208755826,128.19000244140625,139.97000122070312,96.0101759812646,-3.9898240187354115,0.9526602597044871,0.4927340766844207,0.0776361783598658,347715600.0,1.0
193,2023-10-10,GOOG,139.50999450683594,140.74000549316406,138.42999267578125,139.1999969482422,19554900.0,0.0,0.0,-0.3000030517578125,0.3000030517578125,0.0,66.17264757310724,128.19000244140625,140.74000549316406,87.7290185622212,-12.270981437778806,1.165888167257208,0.6273648947989783,0.05887714771855812,328160700.0,-1.0
194,2023-10-11,GOOG,139.85000610351562,142.22000122070312,139.83999633789062,141.6999969482422,20146300.0,0.0,0.0,2.5,0.0,2.5,72.93459726941926,128.19000244140625,142.22000122070312,96.29362567566098,-3.7063743243390213,1.5190907363194128,0.8057100631030653,0.06437310712166955,348307000.0,1.0
195,2023-10-12,GOOG,142.16000366210938,142.3800048828125,139.4499969482422,140.2899932861328,18173100.0,0.0,0.0,-1.410003662109375,1.410003662109375,0.0,64.53895380354427,128.19000244140625,142.3800048828125,85.27123863924744,-14.728761360752552,1.6660259235711692,0.9777732351966861,0.06401203482683915,330133900.0,-1.0
196,2023-10-13,GOOG,140.64999389648438,141.33999633789062,137.97000122070312,138.5800018310547,19438700.0,0.0,0.0,-1.709991455078125,1.709991455078125,0.0,55.58527052155087,128.19000244140625,142.3800048828125,73.2205609727772,-26.779439027222796,1.6257504912114484,1.1073686863996386,0.025227518741602006,310695200.0,-1.0
197,2023-10-16,GOOG,139.72999572753906,140.90499877929688,139.32000732421875,140.49000549316406,17345600.0,0.0,0.0,1.910003662109375,0.0,1.910003662109375,62.322088260525845,129.3800048828125,142.3800048828125,85.46154315655048,-14.538456843449518,1.7280335239749718,1.2315016539147052,0.05393850170141801,328040800.0,1.0
198,2023-10-17,GOOG,140.02999877929688,141.25,138.5290069580078,140.99000549316406,17424000.0,0.0,0.0,0.5,0.0,0.5,63.97269372805519,130.69000244140625,142.3800048828125,88.10950299954577,-11.89049700045424,1.8283631442112949,1.3508739519740234,0.034637125359340715,345464800.0,1.0
199,2023-10-18,GOOG,140.75,141.99000549316406,138.7050018310547,139.27999877929688,18304900.0,0.0,0.0,-1.7100067138671875,1.7100067138671875,0.0,54.54348857996796,131.32000732421875,142.3800048828125,71.97100553510626,-28.028994464893742,1.7497221581426743,1.4306435932077537,0.024192905016819033,327159900.0,-1.0
200,2023-10-19,GOOG,139.8000030517578,141.0050048828125,138.60000610351562,138.97999572753906,21831200.0,0.0,0.0,-0.3000030517578125,0.3000030517578125,0.0,52.96322110929669,132.06500244140625,142.3800048828125,67.03821279164029,-32.961787208359716,1.6442371327557908,1.4733623011173613,0.0018020616139209356,305328700.0,-1.0
201,2023-10-20,GOOG,138.58999633789062,139.0399932861328,136.2449951171875,136.74000549316406,24953900.0,0.0,0.0,-2.239990234375,2.239990234375,0.0,42.38391628276739,132.81500244140625,142.3800048828125,41.03504495478997,-58.96495504521003,1.3641657741503366,1.4515229957239566,-0.019784906859038998,280374800.0,-1.0
202,2023-10-23,GOOG,136.22999572753906,139.02000427246094,135.11000061035156,137.89999389648438,20780700.0,0.0,0.0,1.1599884033203125,0.0,1.1599884033203125,48.52739449659271,133.42999267578125,142.3800048828125,49.94407959791867,-50.055920402081334,1.2217252717277347,1.4055634509247124,-0.009339102588063919,301155500.0,1.0
203,2023-10-24,GOOG,139.16000366210938,140.7100067138672,138.75,140.1199951171875,26535200.0,0.0,0.0,2.220001220703125,0.0,2.220001220703125,58.33731183809484,134.4550018310547,142.3800048828125,71.48253759821938,-28.51746240178061,1.2732978817523701,1.379110337090244,-0.011150330734529312,327690700.0,1.0
204,2023-10-25,GOOG,129.77000427246094,130.10000610351562,126.08999633789062,126.66999816894533,58796100.0,0.0,0.0,-13.449996948242173,13.449996948242173,0.0,25.012649017770826,126.08999633789062,142.3800048828125,3.5604759166041515,-96.43952408339584,0.22625916588498285,1.1485401028491917,-0.09708458029082945,268894600.0,-1.0
205,2023-10-26,GOOG,124.47000122070312,125.45999908447266,122.31999969482422,123.44000244140624,33907400.0,0.0,0.0,-3.229995727539091,3.229995727539091,0.0,21.594505571092796,122.31999969482422,142.3800048828125,5.583262497123694,-94.4167375028763,-0.8543122088306063,0.747969640513232,-0.10925096831868919,234987200.0,-1.0
206,2023-10-27,GOOG,124.02999877929688,124.44000244140624,121.45999908447266,123.4000015258789,37367700.0,0.0,0.0,-0.04000091552732954,0.04000091552732954,0.0,21.55241910027172,121.45999908447266,142.3800048828125,9.273431662051468,-90.72656833794854,-1.6943689160224835,0.25950192920608883,-0.12164569221343446,197619500.0,-1.0
207,2023-10-30,GOOG,124.45999908447266,126.5500030517578,123.87999725341795,125.75,24165600.0,0.0,0.0,2.3499984741210938,0.0,2.3499984741210938,30.706919888873287,121.45999908447266,142.3800048828125,20.506690853153525,-79.49330914684649,-2.1457597078545234,-0.22155039820603378,-0.10809280728698867,221785100.0,1.0
208,2023-10-31,GOOG,126.2699966430664,126.55999755859376,123.9250030517578,125.3000030517578,21123400.0,0.0,0.0,-0.4499969482422017,0.4499969482422017,0.0,29.93508310206269,121.45999908447266,142.3800048828125,18.355654411863856,-81.64434558813615,-2.5108575482357764,-0.6794118282119825,-0.10037331885457423,200661700.0,-1.0
209,2023-11-01,GOOG,125.33999633789062,127.73999786376952,124.9250030517578,127.56999969482422,26536600.0,0.0,0.0,2.2699966430664205,0.0,2.2699966430664205,38.87748144998901,121.45999908447266,141.99000549316406,29.76131857301752,-70.23868142698248,-2.587206765596278,-1.0609708156888418,-0.08209811759588315,227198300.0,1.0
210,2023-11-02,GOOG,129.55999755859375,130.08999633789062,128.11000061035156,128.5800018310547,24091700.0,0.0,0.0,1.0100021362304688,0.0,1.0100021362304688,42.636171494985895,121.45999908447266,141.99000549316406,34.68095725273504,-65.31904274726496,-2.5369707258906544,-1.3561707977292043,-0.05967532056679137,251290000.0,1.0
211,2023-11-03,GOOG,129.08999633789062,130.72999572753906,129.00999450683594,130.3699951171875,19517900.0,0.0,0.0,1.7899932861328125,0.0,1.7899932861328125,49.043957247361945,121.45999908447266,141.99000549316406,43.39986970945506,-56.600130290544946,-2.3259091813682744,-1.5501184744570184,-0.05460477964160981,270807900.0,1.0
212,2023-11-06,GOOG,130.22000122070312,131.55999755859375,129.92999267578125,131.4499969482422,15360400.0,0.0,0.0,1.0800018310546875,0.0,1.0800018310546875,52.72068934116543,121.45999908447266,141.99000549316406,48.66047123852943,-51.33952876147057,-2.0478874985803373,-1.6496722792816825,-0.061875524343933064,286168300.0,1.0
213,2023-11-07,GOOG,131.97999572753906,133.27999877929688,131.13999938964844,132.39999389648438,19223800.0,0.0,0.0,0.9499969482421875,0.0,0.9499969482421875,55.946870036647944,121.45999908447266,141.0050048828125,55.9733515808983,-44.026648419101704,-1.7309432661129733,-1.665926476647941,0.045235618618204354,305392100.0,1.0
214,2023-11-08,GOOG,132.36000061035156,133.5399932861328,132.16000366210938,133.25999450683594,15093600.0,0.0,0.0,0.8600006103515625,0.0,0.8600006103515625,58.87788132136707,121.45999908447266,140.7100067138672,61.29865322414122,-38.70134677585878,-1.3942952529344552,-1.611600231905244,0.07955275333124678,320485700.0,1.0
215,2023-11-09,GOOG,133.36000061035156,133.9600067138672,131.50999450683594,131.69000244140625,17976500.0,0.0,0.0,-1.5699920654296875,1.5699920654296875,0.0,51.64055395778315,121.45999908447266,140.7100067138672,53.142853519250046,-46.857146480749954,-1.2398918077795145,-1.5372585470800983,0.06717990934375151,302509200.0,-1.0
216,2023-11-10,GOOG,131.52999877929688,134.27000427246094,130.8699951171875,134.05999755859375,20872900.0,0.0,0.0,2.3699951171875,0.0,2.3699951171875,60.16859965891016,121.45999908447266,140.7100067138672,65.45451158617229,-34.545488413827705,-0.9157311966639838,-1.4129530769968757,0.06608347959120286,323382100.0,1.0
217,2023-11-13,GOOG,133.36000061035156,134.11000061035156,132.77000427246094,133.63999938964844,16409900.0,0.0,0.0,-0.4199981689453125,0.4199981689453125,0.0,58.07448051116935,121.45999908447266,134.27000427246094,95.08193108771536,-4.91806891228463,-0.6848276506511013,-1.267327991727721,0.06656022453922539,306972200.0,-1.0
218,2023-11-14,GOOG,135.64999389648438,137.24000549316406,135.10000610351562,135.42999267578125,22317300.0,0.0,0.0,1.7899932861328125,0.0,1.7899932861328125,64.20148751300847,121.45999908447266,137.24000549316406,88.52970797029663,-11.470292029703376,-0.3533245295048175,-1.0845272992831403,0.06161317707736824,329289500.0,1.0
219,2023-11-15,GOOG,136.63999938964844,136.83999633789062,135.3300018310547,136.3800048828125,15840900.0,0.0,0.0,0.95001220703125,0.0,0.95001220703125,67.14208521485153,121.45999908447266,137.24000549316406,94.55006171684515,-5.4499382831548555,-0.013788925244170969,-0.8703796244753463,0.06066264536227406,345130400.0,1.0
220,2023-11-16,GOOG,136.9600067138672,138.8800048828125,136.0800018310547,138.6999969482422,17615100.0,0.0,0.0,2.3199920654296875,0.0,2.3199920654296875,73.31791844889433,123.87999725341795,138.8800048828125,98.79994771324274,-1.2000522867572587,0.4374567219987,-0.608812355180537,0.06389508432187152,362745500.0,1.0
221,2023-11-17,GOOG,137.82000732421875,138.0,135.47999572753906,136.94000244140625,25565300.0,0.0,0.0,-1.7599945068359375,1.7599945068359375,0.0,62.95957987891596,123.9250030517578,138.8800048828125,87.02773517969251,-12.972264820307489,0.6456130797896549,-0.35792726818649856,0.041764972389658706,337180200.0,-1.0
222,2023-11-20,GOOG,135.5,138.4250030517578,135.49000549316406,137.9199981689453,19569400.0,0.0,0.0,0.9799957275390625,0.0,0.9799957275390625,66.04194160379468,124.9250030517578,138.8800048828125,93.12069804440412,-6.879301955595885,0.8795174259704766,-0.11043832935510349,0.041691877091600826,356749600.0,1.0
223,2023-11-21,GOOG,137.94000244140625,138.96499633789062,137.7050018310547,138.6199951171875,17648100.0,0.0,0.0,0.6999969482421875,0.0,0.6999969482421875,68.22146456443802,128.11000061035156,138.96499633789062,96.82172863663263,-3.178271363367365,1.1085930368272727,0.13336794388137183,0.040222128405360325,374397700.0,1.0
224,2023-11-22,GOOG,139.10000610351562,141.10000610351562,139.0,140.02000427246094,17306400.0,0.0,0.0,1.4000091552734375,0.0,1.4000091552734375,72.32113964522637,129.00999450683594,141.10000610351562,91.06699094191694,-8.933009058083048,1.3871163304007155,0.3841176211852406,0.06325462583813835,391704100.0,1.0
225,2023-11-24,GOOG,139.5399932861328,139.677001953125,137.47000122070312,138.22000122070312,8828600.0,0.0,0.0,-1.8000030517578125,1.8000030517578125,0.0,60.70346266030468,129.92999267578125,141.10000610351562,74.21663902693577,-25.78336097306424,1.445935009090391,0.5964810987662709,0.031030909576819532,382875500.0,-1.0
226,2023-11-27,GOOG,137.57000732421875,139.6300048828125,137.5399932861328,138.0500030517578,17886400.0,0.0,0.0,-0.1699981689453125,0.1699981689453125,0.0,59.65910400204261,130.8699951171875,141.10000610351562,70.18573043729882,-29.814269562701174,1.4619790203709044,0.7695806830871976,0.032999129618755285,364989100.0,-1.0
227,2023-11-28,GOOG,137.6300048828125,138.66000366210938,137.0399932861328,138.6199951171875,17046900.0,0.0,0.0,0.5699920654296875,0.0,0.5699920654296875,62.1766024824985,130.8699951171875,141.10000610351562,75.7574943991504,-24.242505600849597,1.5033578365395783,0.9163361137776739,0.023554623155323418,382036000.0,1.0
228,2023-11-29,GOOG,138.98500061035156,139.6699981689453,136.2949981689453,136.39999389648438,21014700.0,0.0,0.0,-2.220001220703125,2.220001220703125,0.0,48.55838608757429,130.8699951171875,141.10000610351562,54.056626006437625,-45.94337399356238,1.3415507430281934,1.001379039627778,0.0001465685067914002,361021300.0,-1.0
229,2023-11-30,GOOG,136.39999389648438,136.9600067138672,132.7899932861328,133.9199981689453,29913500.0,0.0,0.0,-2.4799957275390625,2.4799957275390625,0.0,37.86765737965747,130.8699951171875,141.10000610351562,29.814269562701174,-70.18573043729882,1.0016560628565685,1.0014344442735361,-0.034462861459763405,331107800.0,-1.0
230,2023-12-01,GOOG,133.32000732421875,133.5,132.15199279785156,133.32000732421875,24258400.0,0.0,0.0,-0.5999908447265625,0.5999908447265625,0.0,35.675105260280674,132.15199279785156,141.10000610351562,13.053339176729187,-86.94666082327082,0.6760794114482565,0.9363634377084802,-0.026434898880160485,306849400.0,-1.0
231,2023-12-04,GOOG,131.29400634765625,131.4499969482422,129.39999389648438,130.6300048828125,24117100.0,0.0,0.0,-2.69000244140625,2.69000244140625,0.0,27.452355723476913,129.39999389648438,141.10000610351562,10.512903444570226,-89.48709655542977,0.1987062949265237,0.788832009152089,-0.0528566805605879,282732300.0,-1.0
232,2023-12-05,GOOG,130.3699951171875,133.5399932861328,129.72999572753906,132.38999938964844,19235100.0,0.0,0.0,1.7599945068359375,0.0,1.7599945068359375,38.204924115174926,129.39999389648438,141.10000610351562,25.555575842623362,-74.44442415737664,-0.03717002061145536,0.6236316031993802,-0.04494298042841727,301967400.0,1.0
233,2023-12-06,GOOG,132.89999389648438,133.30999755859375,131.30999755859375,131.42999267578125,16360600.0,0.0,0.0,-0.9600067138671875,0.9600067138671875,0.0,34.945155728500836,129.39999389648438,141.10000610351562,17.350398814771538,-82.64960118522846,-0.2981315428046116,0.4392789739985818,-0.06134845975268388,285606800.0,-1.0
234,2023-12-07,GOOG,136.60000610351562,140.0,136.22999572753906,138.4499969482422,38419400.0,0.0,0.0,7.0200042724609375,0.0,7.0200042724609375,62.17544454414831,129.39999389648438,141.10000610351562,77.35037273139864,-22.649627268601357,0.06080926819416277,0.363585032837698,0.001663982965618871,324026200.0,1.0
235,2023-12-08,GOOG,135.66000366210938,137.99000549316406,135.57000732421875,136.63999938964844,22990900.0,0.0,0.0,-1.80999755859375,1.80999755859375,0.0,55.2903421567296,129.39999389648438,141.10000610351562,61.880324268491805,-38.11967573150819,0.19695045025784452,0.33025811632172736,-0.01021371699340512,301035300.0,-1.0
236,2023-12-11,GOOG,133.82000732421875,134.7899932861328,132.88999938964844,134.6999969482422,24502900.0,0.0,0.0,-1.94000244140625,1.94000244140625,0.0,48.63038539807168,129.39999389648438,141.10000610351562,45.29912412033825,-54.70087587966175,0.1466112921515048,0.29352875148768287,-0.028278735442397007,276532400.0,-1.0
237,2023-12-12,GOOG,133.27000427246094,134.5399932861328,132.8300018310547,133.63999938964844,26584000.0,0.0,0.0,-1.05999755859375,1.05999755859375,0.0,45.19803085667318,129.39999389648438,141.10000610351562,36.239325379643496,-63.760674620356504,0.02094278792984028,0.23901155877611435,-0.02023456473854779,249948400.0,-1.0
238,2023-12-13,GOOG,134.5449981689453,134.77999877929688,132.9499969482422,133.97000122070312,25414500.0,0.0,0.0,0.3300018310546875,0.0,0.3300018310546875,46.5531148684421,129.39999389648438,140.0,43.11325181881782,-56.88674818118218,-0.05142917397083124,0.18092341222672523,0.000373380021217784,275362900.0,1.0
239,2023-12-14,GOOG,134.77000427246094,135.03500366210938,131.05999755859375,133.1999969482422,29619100.0,0.0,0.0,-0.7700042724609375,0.7700042724609375,0.0,43.647399169498904,129.39999389648438,140.0,35.84906475192966,-64.15093524807034,-0.1689696077675933,0.11094480822786151,-0.0009001677871552927,245743800.0,-1.0
240,2023-12-15,GOOG,132.9199981689453,134.8300018310547,132.6300048828125,133.83999633789062,58569400.0,0.0,0.0,0.6399993896484375,0.0,0.6399993896484375,46.83016038221933,129.39999389648438,140.0,41.886791366409376,-58.11320863359062,-0.2080800296909615,0.04713984064409689,0.02457315574593899,304313200.0,1.0
241,2023-12-18,GOOG,133.86000061035156,138.3800048828125,133.77000427246094,137.19000244140625,25699800.0,0.0,0.0,3.350006103515625,0.0,3.350006103515625,60.35407899705313,129.39999389648438,140.0,73.4906043340694,-26.509395665930597,0.03088613634901094,0.043889099785079703,0.036256538060933874,330013000.0,1.0
242,2023-12-19,GOOG,138.0,138.77000427246094,137.4499969482422,138.10000610351562,20661000.0,0.0,0.0,0.910003662109375,0.0,0.910003662109375,63.281390087740846,129.39999389648438,140.0,82.07553959941383,-17.924460400586167,0.2903512459496653,0.09318152901799684,0.050749553370122547,350674000.0,1.0
243,2023-12-20,GOOG,140.3300018310547,143.0780029296875,139.41000366210938,139.66000366210938,33507300.0,0.0,0.0,1.55999755859375,0.0,1.55999755859375,67.96070245965558,129.39999389648438,143.0780029296875,75.01098837351992,-24.989011626480085,0.6147712787306716,0.19749947896053185,0.008739665876045688,384181300.0,1.0
244,2023-12-21,GOOG,140.77000427246094,142.02999877929688,140.47300720214844,141.8000030517578,18101500.0,0.0,0.0,2.1399993896484375,0.0,2.1399993896484375,73.33863988807477,129.39999389648438,143.0780029296875,90.65653579532398,-9.343464204676028,1.0326527785608164,0.3645301388805888,0.037763493011990557,402282800.0,1.0
245,2023-12-22,GOOG,142.1300048828125,143.25,142.05499267578125,142.72000122070312,18494700.0,0.0,0.0,0.9199981689453125,0.0,0.9199981689453125,75.38792423548642,129.72999572753906,143.25,96.07989192446902,-3.9201080755309823,1.4216748580879823,0.5759590827220676,0.05953975095888531,420777500.0,1.0
246,2023-12-26,GOOG,142.97999572753906,143.94500732421875,142.5,142.82000732421875,11170100.0,0.0,0.0,0.100006103515625,0.0,0.100006103515625,75.62293555324659,131.05999755859375,143.94500732421875,91.26892396308999,-8.731076036910018,1.7182405085428343,0.8044153678862211,0.0686920680671701,431947600.0,1.0
247,2023-12-27,GOOG,142.8300018310547,143.32000732421875,141.05099487304688,141.44000244140625,17288400.0,0.0,0.0,-1.3800048828125,1.3800048828125,0.0,65.64293533542661,131.05999755859375,143.94500732421875,80.55876612918507,-19.44123387081494,1.8209255663665829,1.0077174075822937,0.05575876056309803,414659200.0,-1.0
248,2023-12-28,GOOG,141.85000610351562,142.27000427246094,140.8280029296875,141.27999877929688,12192500.0,0.0,0.0,-0.160003662109375,0.160003662109375,0.0,64.50409842422113,131.05999755859375,143.94500732421875,79.31698467135305,-20.68301532864695,1.8678617091298975,1.1797462678918145,0.06066067579711998,402466700.0,-1.0
249,2023-12-29,GOOG,140.67999267578125,141.43499755859375,139.89999389648438,140.92999267578125,14872700.0,0.0,0.0,-0.350006103515625,0.350006103515625,0.0,61.79801208762378,131.05999755859375,143.94500732421875,76.60060253519525,-23.399397464804743,1.855428152319007,1.314882644777253,0.05297367402783926,387594000.0,-1.0
250,2024-01-02,GOOG,139.60000610351562,140.61500549316406,137.74000549316406,139.55999755859375,20071900.0,0.0,0.0,-1.3699951171875,1.3699951171875,0.0,51.95414293870972,131.05999755859375,143.94500732421875,65.96813005665346,-34.031869943346535,1.715254921912674,1.3949571002043373,0.01727527571259957,367522100.0,-1.0
251,2024-01-03,GOOG,138.60000610351562,141.08999633789062,138.42999267578125,140.36000061035156,18974300.0,0.0,0.0,0.8000030517578125,0.0,0.8000030517578125,56.610986360362496,131.05999755859375,143.94500732421875,72.1769189230157,-27.82308107698429,1.6497034327933022,1.4459063667221304,0.016364912432675238,386496400.0,1.0
252,2024-01-04,GOOG,139.85000610351562,140.63499450683594,138.00999450683594,138.0399932861328,18253300.0,0.0,0.0,-2.32000732421875,2.32000732421875,0.0,42.74702823606084,131.05999755859375,143.94500732421875,54.17144305284499,-45.82855694715501,1.3944735806312565,1.4356198095039556,-0.011599673016592371,368243100.0,-1.0
253,2024-01-05,GOOG,138.3520050048828,138.80999755859375,136.85000610351562,137.38999938964844,15433200.0,0.0,0.0,-0.649993896484375,0.649993896484375,0.0,39.61106565592267,132.6300048828125,143.94500732421875,42.06799363486798,-57.932006365132025,1.1267643706201511,1.3738487217271949,-0.031100166200276447,352809900.0,-1.0
254,2024-01-08,GOOG,138.0,140.63999938964844,137.8800048828125,140.52999877929688,17645300.0,0.0,0.0,3.1399993896484375,0.0,3.1399993896484375,57.13798876418227,133.77000427246094,143.94500732421875,66.43727252414037,-33.562727475859624,1.1546643490544284,1.3300118471926416,-0.015344747916724133,370455200.0,1.0
255,2024-01-09,GOOG,140.05999755859375,142.8000030517578,139.7899932861328,142.55999755859375,19579700.0,0.0,0.0,2.029998779296875,0.0,2.029998779296875,64.76618858475095,136.85000610351562,143.94500732421875,80.47907642942246,-19.520923570577533,1.3253019625722686,1.3290698702685673,-0.00182054160685452,390034900.0,1.0
256,2024-01-10,GOOG,142.52000427246094,144.52499389648438,142.4600067138672,143.8000030517578,16641900.0,0.0,0.0,1.2400054931640625,0.0,1.2400054931640625,68.69321421483536,136.85000610351562,144.52499389648438,90.55385019125704,-9.446149808742952,1.5428070611173155,1.371817308438317,0.016685524389249196,406676800.0,1.0
257,2024-01-11,GOOG,144.89500427246094,146.66000366210938,142.21499633789062,143.6699981689453,17471100.0,0.0,0.0,-0.1300048828125,0.1300048828125,0.0,67.77934210977125,136.85000610351562,146.66000366210938,69.52083346295271,-30.47916653704729,1.6852644318886973,1.4345067331283932,0.016916756867913163,389205700.0,-1.0
258,2024-01-12,GOOG,144.33999633789062,144.74000549316406,143.36000061035156,144.24000549316406,13995200.0,0.0,0.0,0.57000732421875,0.0,0.57000732421875,69.8111683622551,136.85000610351562,146.66000366210938,75.3313071232587,-24.668692876741307,1.8231417090304092,1.5122337283087965,0.023486929606231666,403200900.0,1.0
259,2024-01-16,GOOG,143.42999267578125,145.83999633789062,143.05599975585938,144.0800018310547,19198900.0,0.0,0.0,-0.160003662109375,0.160003662109375,0.0,68.41385560616567,136.85000610351562,146.66000366210938,73.70028060002363,-26.299719399976357,1.8976248481873483,1.5893119522845072,0.03238753476305578,384002000.0,-1.0
260,2024-01-17,GOOG,142.91000366210938,143.41000366210938,140.50999450683594,142.88999938964844,17884500.0,0.0,0.0,-1.19000244140625,1.19000244140625,0.0,58.385306249665405,136.85000610351562,146.66000366210938,61.56977359124478,-38.43022640875522,1.839426260072969,1.6393348138421997,0.018025069594580057,366117500.0,-1.0
261,2024-01-18,GOOG,143.44000244140625,145.5850067138672,143.35000610351562,144.99000549316406,18876800.0,0.0,0.0,2.100006103515625,0.0,2.100006103515625,67.95121494514633,136.85000610351562,146.66000366210938,82.97656896476634,-17.023431035233656,1.9403888071657036,1.6995456125069008,0.05034781617690376,384994300.0,1.0
262,2024-01-19,GOOG,146.30499267578125,148.0399932861328,145.8000030517578,147.97000122070312,27170900.0,0.0,0.0,2.9799957275390625,0.0,2.9799957275390625,76.7151032825166,136.85000610351562,148.0399932861328,99.37451165682822,-0.6254883431717864,2.2350982814248255,1.8066561462904858,0.07700707386313477,412165200.0,1.0
263,2024-01-22,GOOG,148.7100067138672,150.01499938964844,147.5800018310547,147.7100067138672,21829200.0,0.0,0.0,-0.2599945068359375,0.2599945068359375,0.0,74.65983404034421,136.85000610351562,150.01499938964844,82.49150131957009,-17.508498680429913,2.419784509660701,1.9292818189645289,0.05109235036603499,390336000.0,-1.0
264,2024-01-23,GOOG,147.72000122070312,148.86000061035156,147.19000244140625,148.67999267578125,14113600.0,0.0,0.0,0.9699859619140625,0.0,0.9699859619140625,77.28008957556571,136.85000610351562,150.01499938964844,89.85941971369328,-10.140580286306722,2.6142836026005796,2.066282175691739,0.04292925941354708,404449600.0,1.0
265,2024-01-24,GOOG,150.2899932861328,151.57000732421875,149.83999633789062,150.35000610351562,19245000.0,0.0,0.0,1.670013427734375,0.0,1.670013427734375,81.15182682250463,136.85000610351562,151.57000732421875,91.71194891623216,-8.288051083767844,2.8700969703097314,2.2270451346153375,0.045549394386315,423694600.0,1.0
266,2024-01-25,GOOG,151.74000549316406,154.75999450683594,151.22000122070312,153.63999938964844,21495100.0,0.0,0.0,3.2899932861328125,0.0,3.2899932861328125,86.4144252656503,136.85000610351562,154.75999450683594,93.74653354337255,-6.253466456627439,3.3002624977899018,2.4416886072502506,0.06939515102505345,445189700.0,1.0
267,2024-01-26,GOOG,152.8699951171875,154.11000061035156,152.8000030517578,153.7899932861328,19494500.0,0.0,0.0,0.149993896484375,0.0,0.149993896484375,86.61107937171423,137.8800048828125,154.75999450683594,94.2535437384237,-5.746456261576303,3.611642267474707,2.6756793392951423,0.06620900879972136,464684200.0,1.0
268,2024-01-29,GOOG,153.63999938964844,155.1999969482422,152.9199981689453,154.83999633789062,20909300.0,0.0,0.0,1.0500030517578125,0.0,1.0500030517578125,88.01264445762487,139.7899932861328,155.1999969482422,97.66385123426839,-2.3361487657315996,3.8982033871655517,2.9201841488692244,0.07468069385127363,485593500.0,1.0
269,2024-01-30,GOOG,154.00999450683594,155.0399932861328,152.77499389648438,153.0500030517578,26578900.0,0.0,0.0,-1.7899932861328125,1.7899932861328125,0.0,72.98445044715318,140.50999450683594,155.1999969482422,85.36423730996631,-14.635762690033696,3.93550162760846,3.123247644617072,0.07110367209397173,459014600.0,-1.0
270,2024-01-31,GOOG,145.38999938964844,145.58999633789062,141.5500030517578,141.8000030517578,43908600.0,0.0,0.0,-11.25,11.25,0.0,32.607718561308815,140.50999450683594,155.1999969482422,8.78154071156427,-91.21845928843572,3.0224389776517455,3.103085911224007,-0.022001533350908486,415106000.0,-1.0
271,2024-02-01,GOOG,143.69000244140625,144.6199951171875,142.25999450683594,142.7100067138672,25526900.0,0.0,0.0,0.910003662109375,0.0,0.910003662109375,35.91662670134704,140.50999450683594,155.1999969482422,14.976254876787118,-85.02374512321288,2.3452256382562098,2.9515138566304477,-0.035547708748007945,440632900.0,1.0
272,2024-02-02,GOOG,140.88999938964844,143.8800048828125,138.1699981689453,143.5399932861328,42116900.0,0.0,0.0,0.829986572265625,0.0,0.829986572265625,39.06521355834533,138.1699981689453,155.1999969482422,31.532563136268255,-68.46743686373175,1.854128923501463,2.732036870004651,-0.02823108278515085,482749800.0,1.0
273,2024-02-05,GOOG,144.0399932861328,146.6699981689453,143.91000366210938,144.92999267578125,29254400.0,0.0,0.0,1.3899993896484375,0.0,1.3899993896484375,44.3488831111587,138.1699981689453,155.1999969482422,39.694627078035765,-60.30537292196424,1.5591200079283567,2.497453497589392,-0.025221954430529436,512004200.0,1.0
274,2024-02-06,GOOG,145.9600067138672,146.74000549316406,144.52000427246094,145.41000366210938,21517700.0,0.0,0.0,0.480010986328125,0.0,0.480010986328125,46.207444896370816,138.1699981689453,155.1999969482422,42.513247282,-57.486752718,1.3485113919592777,2.2676650764633695,-0.03285668267951425,533521900.0,1.0
275,2024-02-07,GOOG,146.1199951171875,147.0,145.2100067138672,146.67999267578125,21436100.0,0.0,0.0,1.269989013671875,0.0,1.269989013671875,51.184345092909524,138.1699981689453,155.1999969482422,49.970611373040235,-50.02938862695977,1.2694466552178199,2.0680213922142596,-0.04530074682059726,554958000.0,1.0
276,2024-02-08,GOOG,146.97000122070312,147.61000061035156,146.4199981689453,147.22000122070312,18241300.0,0.0,0.0,0.540008544921875,0.0,0.540008544921875,53.30399931163011,138.1699981689453,155.1999969482422,53.141536702631896,-46.858463297368104,1.2361123248047647,1.9016395787323606,-0.04272054328792341,573199300.0,1.0
277,2024-02-09,GOOG,147.9499969482422,150.69500732421875,147.42999267578125,150.22000122070312,21877700.0,0.0,0.0,3.0,0.0,3.0,63.47135454095694,138.1699981689453,155.1999969482422,70.75750977978241,-29.242490220217583,1.4352251732293269,1.808356697631754,-0.029837220527348607,595077000.0,1.0
278,2024-02-12,GOOG,149.5399932861328,150.58999633789062,148.55999755859375,148.72999572753906,17236100.0,0.0,0.0,-1.4900054931640625,1.4900054931640625,0.0,56.4300479966733,138.1699981689453,155.1999969482422,62.008210895654244,-37.991789104345756,1.4560085887075047,1.737887075846904,-0.02822611720404755,577840900.0,-1.0
279,2024-02-13,GOOG,146.07000732421875,148.0399932861328,145.11000061035156,146.3699951171875,18138500.0,0.0,0.0,-2.3600006103515625,2.3600006103515625,0.0,46.91776152284572,138.1699981689453,155.1999969482422,48.150308490983605,-51.849691509016395,1.2674370440872167,1.6437970694949668,0.032228434182484555,559702400.0,-1.0
280,2024-02-14,GOOG,147.3699951171875,147.8300018310547,145.55499267578125,147.13999938964844,16651800.0,0.0,0.0,0.7700042724609375,0.0,0.7700042724609375,50.08536854222383,138.1699981689453,155.1999969482422,52.67176666863785,-47.32823333136215,1.1666769206507581,1.5483730397261253,0.031041920449652594,576354200.0,1.0
281,2024-02-15,GOOG,144.4600067138672,144.75999450683594,141.8800048828125,143.94000244140625,26724300.0,0.0,0.0,-3.1999969482421875,3.1999969482421875,0.0,38.942236159495415,138.1699981689453,155.1999969482422,33.88141330623845,-66.11858669376154,0.8191679287780573,1.402532017536512,0.0027867435835533527,549629900.0,-1.0
282,2024-02-16,GOOG,144.2100067138672,144.47999572753906,141.52000427246094,141.75999450683594,21849700.0,0.0,0.0,-2.1800079345703125,2.1800079345703125,0.0,33.14556959300158,138.1699981689453,155.0399932861328,21.280363823182512,-78.71963617681749,0.36366403525059354,1.1947584210793283,-0.021872616636618658,527780200.0,-1.0
283,2024-02-20,GOOG,140.94000244140625,143.32899475097656,140.8000030517578,142.1999969482422,18625600.0,0.0,0.0,0.44000244140625,0.0,0.44000244140625,35.38548910802086,138.1699981689453,150.69500732421875,32.17561543737566,-67.82438456262435,0.03774335574931342,0.9633554080133253,-0.022075556241139438,546405800.0,1.0
284,2024-02-21,GOOG,142.63999938964844,143.97999572753906,141.91000366210938,143.83999633789062,16499600.0,0.0,0.0,1.6399993896484375,0.0,1.6399993896484375,43.5233073122655,138.1699981689453,150.69500732421875,45.26941336851685,-54.730586631483156,-0.08721156558425491,0.7532420132938092,-0.019361852193216955,562905400.0,1.0
285,2024-02-22,GOOG,146.1199951171875,146.1999969482422,144.00999450683594,145.32000732421875,23024700.0,0.0,0.0,1.480010986328125,0.0,1.480010986328125,50.071155441411406,138.1699981689453,150.69500732421875,57.08585971183143,-42.91414028816857,-0.06605330204490656,0.5893829502260661,-0.012905813617240969,585930100.0,1.0
286,2024-02-23,GOOG,144.97000122070312,145.9550018310547,144.7899932861328,145.2899932861328,14519400.0,0.0,0.0,-0.0300140380859375,0.0300140380859375,0.0,49.93568400318445,140.8000030517578,150.69500732421875,45.37633446881087,-54.62366553118913,-0.0511178529985159,0.4612827895811497,-0.032818585371512166,571410700.0,-1.0
287,2024-02-26,GOOG,143.4499969482422,143.83999633789062,138.74000549316406,138.75,33513000.0,0.0,0.0,-6.5399932861328125,6.5399932861328125,0.0,29.71941065511126,138.74000549316406,150.69500732421875,0.08360104814016386,-99.91639895185985,-0.5605426167356597,0.25691770831778776,-0.06710143222098641,537897700.0,-1.0
288,2024-02-27,GOOG,139.41000366210938,140.49000549316406,138.5,140.10000610351562,22364000.0,0.0,0.0,1.350006103515625,0.0,1.350006103515625,35.900318985838496,138.5,150.69500732421875,13.120173370770209,-86.8798266292298,-0.8455838380165233,0.03641739905092548,-0.04283657322425927,560261700.0,1.0
289,2024-02-28,GOOG,139.10000610351562,139.27999877929688,136.63999938964844,137.42999267578125,30628700.0,0.0,0.0,-2.670013427734375,2.670013427734375,0.0,29.899546865504874,136.63999938964844,150.69500732421875,5.620724583084087,-94.3792754169159,-1.2722629732369057,-0.22531867540664086,-0.06599161855474567,529633000.0,-1.0
290,2024-02-29,GOOG,138.35000610351562,139.9499969482422,137.57000732421875,139.77999877929688,35485000.0,0.0,0.0,2.350006103515625,0.0,2.350006103515625,40.07232770001619,136.63999938964844,150.69500732421875,22.34078702954808,-77.65921297045192,-1.4045921453317476,-0.46117336939166226,-0.02890095589516739,565118000.0,1.0
291,2024-03-01,GOOG,139.61000061035156,140.0,137.97500610351562,138.0800018310547,28522000.0,0.0,0.0,-1.6999969482421875,1.6999969482421875,0.0,35.74285362340031,136.63999938964844,150.58999633789062,10.322600404494727,-89.67739959550526,-1.6278743911654203,-0.694513573746414,-0.02595931728541223,536596000.0,-1.0
292,2024-03-04,GOOG,136.5399932861328,136.6300048828125,132.86000061035156,134.1999969482422,43571500.0,0.0,0.0,-3.8800048828125,3.8800048828125,0.0,27.825705151896358,132.86000061035156,148.0399932861328,8.827384614147457,-91.17261538585254,-2.093775407523907,-0.9743659405019127,-0.05625879164337699,493024500.0,-1.0
293,2024-03-05,GOOG,132.74000549316406,134.02000427246094,131.5500030517578,133.77999877929688,28447600.0,0.0,0.0,-0.4199981689453125,0.4199981689453125,0.0,27.076610164947667,131.5500030517578,147.8300018310547,13.697763481253618,-86.30223651874638,-2.468441010364103,-1.273180954474351,-0.06993880571966982,464576900.0,-1.0
294,2024-03-06,GOOG,134.24000549316406,134.74000549316406,131.9499969482422,132.55999755859375,23175200.0,0.0,0.0,-1.220001220703125,1.220001220703125,0.0,24.835683693732804,131.5500030517578,146.1999969482422,6.894163328479682,-93.10583667152031,-2.83117408989267,-1.584779581558015,-0.08780628352953879,441401700.0,-1.0
295,2024-03-07,GOOG,133.88999938964844,135.82000732421875,132.66000366210938,135.24000549316406,24107300.0,0.0,0.0,2.6800079345703125,0.0,2.6800079345703125,37.86925908807928,131.5500030517578,146.1999969482422,25.18774046924181,-74.81225953075818,-2.8693127746543325,-1.8416862201772786,-0.06917192000399086,465509000.0,1.0
296,2024-03-08,GOOG,135.03500366210938,138.98500061035156,134.8000030517578,136.2899932861328,26472400.0,0.0,0.0,1.04998779296875,0.0,1.04998779296875,42.38552536759842,131.5500030517578,146.1999969482422,32.35489562567311,-67.64510437432689,-2.7827350795282086,-2.029895992047465,-0.017729778117961725,491981400.0,1.0
297,2024-03-11,GOOG,137.07000732421875,139.97999572753906,137.07000732421875,138.94000244140625,22536400.0,0.0,0.0,2.6500091552734375,0.0,2.6500091552734375,52.45083105844227,131.5500030517578,146.1999969482422,50.44370285657149,-49.556297143428516,-2.471794729619205,-2.118275739561813,-0.008279825921294282,514517800.0,1.0
298,2024-03-12,GOOG,138.25,140.27999877929688,138.2100067138672,139.6199951171875,19019700.0,0.0,0.0,0.67999267578125,0.0,0.67999267578125,54.789349946727,131.5500030517578,146.1999969482422,55.085293020949855,-44.914706979050145,-2.1457674644808264,-2.1237740845456154,0.015935403901045087,533537500.0,1.0
299,2024-03-13,GOOG,140.05999755859375,142.19000244140625,140.00999450683594,140.77000427246094,19637000.0,0.0,0.0,1.1500091552734375,0.0,1.1500091552734375,58.74833949989891,131.5500030517578,145.9550018310547,64.00556752531126,-35.99443247468873,-1.7741411849484905,-2.0538475046261904,0.007082597666403068,553174500.0,1.0
300,2024-03-14,GOOG,142.3000030517578,144.72999572753906,141.48500061035156,144.33999633789062,36117900.0,0.0,0.0,3.5699920654296875,0.0,3.5699920654296875,68.59788798697929,131.5500030517578,144.72999572753906,97.04097415497752,-2.959025845022483,-1.1779771694638157,-1.8786734375937153,0.04533599669628652,589292400.0,1.0
301,2024-03-15,GOOG,143.41000366210938,144.33999633789062,141.1300048828125,142.1699981689453,41025900.0,0.0,0.0,-2.1699981689453125,2.1699981689453125,0.0,58.75815989193008,131.5500030517578,144.72999572753906,80.57663898935358,-19.423361010646424,-0.8705781261301411,-1.6770543753010005,0.05938898213072963,548266500.0,-1.0
302,2024-03-18,GOOG,149.3699951171875,152.92999267578125,148.13999938964844,148.47999572753906,47676700.0,0.0,0.0,6.30999755859375,0.0,6.30999755859375,72.15781037624309,131.5500030517578,152.92999267578125,79.18615945799156,-20.81384054200844,-0.11645567299726167,-1.3649346348402527,0.10988187384044945,595943200.0,1.0
303,2024-03-19,GOOG,148.97999572753906,149.6199951171875,147.00999450683594,147.9199981689453,17748400.0,0.0,0.0,-0.55999755859375,0.55999755859375,0.0,69.83438049609794,131.5500030517578,152.92999267578125,76.56689925982705,-23.433100740172957,0.43103596707035763,-1.0057405144581306,0.11587206467442934,578194800.0,-1.0
304,2024-03-20,GOOG,148.7899932861328,149.75999450683594,147.6649932861328,149.67999267578125,17730000.0,0.0,0.0,1.7599945068359375,0.0,1.7599945068359375,72.98843410780654,131.5500030517578,152.92999267578125,84.79887007827091,-15.201129921729084,0.9954687401149727,-0.6054986635435098,0.10677304492824113,595924800.0,1.0
305,2024-03-21,GOOG,150.32000732421875,151.30499267578125,148.00999450683594,148.74000549316406,19843900.0,0.0,0.0,-0.9399871826171875,0.9399871826171875,0.0,68.5701804962074,131.5500030517578,152.92999267578125,80.402295528202,-19.597704471797993,1.351359043576025,-0.21412712211960272,0.09134942270408053,576080900.0,-1.0
306,2024-03-22,GOOG,150.24000549316406,152.55999755859375,150.08999633789062,151.77000427246094,19226300.0,0.0,0.0,3.029998779296875,0.0,3.029998779296875,74.34607056804157,131.5500030517578,152.92999267578125,94.57442017643965,-5.425579823560352,1.8564996791696728,0.19999823813825254,0.09234202969346672,595307200.0,1.0
307,2024-03-25,GOOG,150.9499969482422,151.45599365234375,148.8000030517578,151.14999389648438,15114700.0,0.0,0.0,-0.6200103759765625,0.6200103759765625,0.0,71.25440055472302,131.9499969482422,152.92999267578125,91.51573335660699,-8.484266643393008,2.1816489257363685,0.5963283756578759,0.08258128622350536,580192500.0,-1.0
308,2024-03-26,GOOG,151.24000549316406,153.1999969482422,151.02999877929688,151.6999969482422,19312700.0,0.0,0.0,0.5500030517578125,0.0,0.5500030517578125,72.42799361542036,132.66000366210938,153.1999969482422,92.69717385442041,-7.302826145579592,2.455408277734449,0.9681443560731907,0.07764433007067484,599505200.0,1.0
309,2024-03-27,GOOG,152.14500427246094,152.69000244140625,150.1300048828125,151.94000244140625,16622000.0,0.0,0.0,0.2400054931640625,0.0,0.2400054931640625,72.9833623799189,134.8000030517578,153.1999969482422,93.15220149569353,-6.847798504306462,2.661055977155428,1.3067266802896382,0.05265350073672237,616127200.0,1.0
310,2024-03-28,GOOG,152.0,152.6699981689453,151.3300018310547,152.25999450683594,21105600.0,0.0,0.0,0.3199920654296875,0.0,0.3199920654296875,73.79536445344635,137.07000732421875,153.1999969482422,94.1723307744337,-5.827669225566293,2.8173769779068323,1.6088567398130773,0.07097134745616551,637232800.0,1.0
311,2024-04-01,GOOG,151.8300018310547,157.0,151.64999389648438,156.5,24469800.0,0.0,0.0,4.2400054931640625,0.0,4.2400054931640625,82.04567166043113,138.2100067138672,157.0,97.3390091609612,-2.6609908390388015,3.245977892719935,1.9362809703944492,0.05401403894958112,661702600.0,1.0
312,2024-04-02,GOOG,154.75,155.99000549316406,153.4600067138672,155.8699951171875,17598100.0,0.0,0.0,-0.6300048828125,0.6300048828125,0.0,77.84381244833305,140.00999450683594,157.0,93.34900225154631,-6.6509977484536895,3.494528329427709,2.2479304422011013,0.053745247746435076,644104500.0,-1.0
313,2024-04-03,GOOG,154.9199981689453,156.5500030517578,154.1320037841797,156.3699951171875,17266200.0,0.0,0.0,0.5,0.0,0.5,78.8363575130524,141.1300048828125,157.0,96.03021375772074,-3.969786242279262,3.689323932779331,2.5362091403167475,0.044695368578066,661370700.0,1.0
314,2024-04-04,GOOG,155.0800018310547,156.17999267578125,151.8800048828125,151.94000244140625,24184800.0,0.0,0.0,-4.42999267578125,4.42999267578125,0.0,54.07272429803806,141.1300048828125,157.0,68.1159476028214,-31.884052397178614,3.4465082640386697,2.718268965061132,0.021514030052858013,637185900.0,-1.0
315,2024-04-05,GOOG,151.67999267578125,154.83999633789062,151.08099365234375,153.94000244140625,16289800.0,0.0,0.0,2.0,0.0,2.0,60.531028740067065,147.00999450683594,157.0,69.36941065059837,-30.63058934940164,3.376535779818454,2.8499223280125965,0.014297938379508102,653475700.0,1.0
316,2024-04-08,GOOG,154.01499938964844,156.65499877929688,153.99000549316406,156.13999938964844,16641500.0,0.0,0.0,2.1999969482421875,0.0,2.1999969482421875,66.5085574677245,147.00999450683594,157.0,91.39139001535042,-8.608609984649576,3.4587333247456513,2.9716845273592076,0.03301360036164791,670117200.0,1.0
317,2024-04-09,GOOG,157.35000610351562,159.88999938964844,156.63999938964844,158.13999938964844,21538100.0,0.0,0.0,2.0,0.0,2.0,71.09972977951587,147.6649932861328,159.88999938964844,85.68507872158247,-14.31492127841753,3.6432615058132285,3.105999923050012,0.042452225253527764,691655300.0,1.0
318,2024-04-10,GOOG,157.8800048828125,158.16000366210938,156.1999969482422,157.66000366210938,16339200.0,0.0,0.0,-0.4799957275390625,0.4799957275390625,0.0,68.49938062067284,148.00999450683594,159.88999938964844,81.22899990752252,-18.771000092477472,3.708025959942688,3.2264051304285477,0.037646446813168755,675316100.0,-1.0
319,2024-04-11,GOOG,158.33999633789062,161.1199951171875,157.92999267578125,160.7899932861328,17832800.0,0.0,0.0,3.1299896240234375,0.0,3.1299896240234375,75.2971227945883,148.8000030517578,161.1199951171875,97.32141198385442,-2.678588016145593,3.966196417255503,3.3743633877939394,0.05602258693706896,693148900.0,1.0
653,2023-01-23,META,139.14235633079062,143.60761968515436,138.51303444856106,143.11814880371094,27470100.0,0.0,0.0,3.8958740234375,0.0,3.8958740234375,82.85725717688713,122.15039631217508,143.60761968515436,97.71885265425439,-2.2811473457456115,1.4563174645503807,1.012774292337839,0.10658836829321738,107749100.0,1.0
654,2023-01-24,META,141.53982119459295,144.84631039302204,141.21016914182596,142.98828125,21970200.0,0.0,0.0,-0.1298675537109375,0.1298675537109375,0.0,82.07976282242306,124.40800031713944,144.84631039302204,90.90908623989158,-9.090913760108421,1.7163877838338522,1.1534969906370418,0.07632148552874063,85778900.0,-1.0
655,2023-01-25,META,141.07031935923027,143.01824946729005,140.16128022793035,141.3500213623047,26622000.0,0.0,0.0,-1.6382598876953125,1.6382598876953125,0.0,72.21624889002462,124.40800031713944,144.84631039302204,82.89345343261523,-17.10654656738477,1.7927944883276439,1.2813564901751624,0.06479044231577369,59156900.0,-1.0
656,2023-01-26,META,144.24693977817574,147.35364400056693,143.14811484851845,147.1438751220703,25482100.0,0.0,0.0,5.793853759765625,0.0,5.793853759765625,81.35787738030473,125.90641701099464,147.35364400056693,99.02193006770243,-0.9780699322975804,2.1873668593037223,1.4625585640008745,0.07746316703447209,84639000.0,1.0
657,2023-01-27,META,148.08288746965303,153.02763796816456,147.2337822786712,151.5791778564453,35771900.0,0.0,0.0,4.435302734375,0.0,4.435302734375,85.55576553421743,127.01523085413356,153.02763796816456,94.43165676529048,-5.56834323470952,2.7423381444834547,1.7185144800973908,0.10775306140791652,120410900.0,1.0
658,2023-01-30,META,149.25164436613778,150.95982340547195,146.79424500734552,146.9041290283203,28040100.0,0.0,0.0,-4.675048828125,4.675048828125,0.0,67.16202437201835,127.01523085413356,153.02763796816456,76.45927609467081,-23.540723905329184,2.835584380041837,1.9419284600862803,0.0864361103377953,92370800.0,-1.0
659,2023-01-31,META,147.79318013335583,149.72114239233812,147.36364322021893,148.81210327148438,29842100.0,0.0,0.0,1.9079742431640625,0.0,1.9079742431640625,70.18092753702567,130.20184527665958,153.02763796816456,81.53170514753222,-18.468294852467782,2.9976060020319437,2.153063968475413,0.11990674706910909,122212900.0,1.0
660,2023-02-01,META,147.87310120581347,153.41722178767446,146.9041280931902,152.95770263671875,55661000.0,0.0,0.0,4.145599365234375,0.0,4.145599365234375,75.76633263625752,131.62034351042325,153.41722178767446,97.89181209753646,-2.108187902463543,3.361130599541866,2.394677294688704,0.12464192430409082,177873900.0,1.0
661,2023-02-02,META,183.18564438432827,196.95103804114427,179.96905597323203,188.56993103027344,150475700.0,0.0,0.0,35.61222839355469,0.0,35.61222839355469,91.51662905827177,131.99994712599852,196.95103804114427,87.09627984259697,-12.903720157403036,5.991261947202247,3.113994225191413,0.35445230533607197,328349600.0,1.0
662,2023-02-03,META,183.27553646399733,196.56144248713773,182.69614939238136,186.3322906494141,76809700.0,0.0,0.0,-2.2376403808593466,2.2376403808593466,0.0,87.39838532715612,131.99994712599852,196.95103804114427,83.65116391100672,-16.348836088993274,7.808005091567281,4.052796398466588,0.30194732259269297,251539900.0,-1.0
663,2023-02-06,META,186.3322960361737,190.4978744330597,185.3233720203357,185.86279296875,42483800.0,0.0,0.0,-0.4694976806640909,0.4694976806640909,0.0,86.45649417103543,131.99994712599852,196.95103804114427,82.92831588174505,-17.07168411825495,9.09459321003203,5.061155760779677,0.2998463324682421,209056100.0,-1.0
664,2023-02-07,META,185.38330902560568,193.5746149490149,184.2045517595816,191.4169006347656,47080700.0,0.0,0.0,5.554107666015597,0.0,5.554107666015597,88.193311574642,131.99994712599852,196.95103804114427,91.47953124665965,-8.52046875334035,10.374195425050488,6.1237636936338395,0.3542049643143017,256136800.0,1.0
665,2023-02-08,META,189.7986244046801,190.62774654040405,182.72612646617063,183.23558044433597,36139100.0,0.0,0.0,-8.18132019042963,8.18132019042963,0.0,72.41058234292343,134.4673254626238,196.95103804114427,78.04954758478426,-21.950452415215736,10.674259774679257,7.033862909842924,0.24528173729503888,219997700.0,-1.0
666,2023-02-09,META,185.93273541018135,186.45217331465105,177.08212505181535,177.73143005371094,37118800.0,0.0,0.0,-5.504150390625028,5.504150390625028,0.0,63.57834943314866,138.51303444856106,196.95103804114427,67.11111467560019,-32.88888532439981,10.393175920679852,7.705725512010309,0.17253195700819401,182878900.0,-1.0
667,2023-02-10,META,176.16308868884838,178.70038977786248,173.16626845762974,173.9654083251953,33433600.0,0.0,0.0,-3.766021728515625,3.766021728515625,0.0,57.993772596705114,140.16128022793035,196.95103804114427,59.52504359756112,-40.47495640243887,9.78358134796892,8.121296679202032,0.18421047438127558,149445300.0,-1.0
668,2023-02-13,META,178.03111335157158,180.80816572731095,175.63366310748273,179.2398223876953,31463200.0,0.0,0.0,5.2744140625,0.0,5.2744140625,63.21519455344825,140.16128022793035,196.95103804114427,68.81265859294106,-31.18734140705895,9.574393604752117,8.411916064312049,0.2044707281685303,180908500.0,1.0
669,2023-02-14,META,176.97223130460725,181.3176115825064,175.69358919940962,179.28976440429688,24034600.0,0.0,0.0,0.0499420166015625,0.0,0.0499420166015625,63.26508230651943,143.14811484851845,196.95103804114427,67.17413740956731,-32.8258625904327,9.303592050975851,8.59025126164481,0.1721525710288545,204943100.0,1.0
670,2023-02-15,META,176.23300785413616,178.00113607139045,175.14416682040877,176.97222900390625,25308900.0,0.0,0.0,-2.317535400390625,2.317535400390625,0.0,58.982029754167066,146.79424500734552,196.95103804114427,60.16729174894601,-39.83270825105399,8.8147975909732,8.635160527510488,-0.06150345372139565,179634200.0,-1.0
671,2023-02-16,META,172.56690165708818,175.66362205304625,171.60791245777088,172.25723266601562,25827500.0,0.0,0.0,-4.714996337890625,4.714996337890625,0.0,50.8937419064135,146.79424500734552,196.95103804114427,50.76677777526878,-49.23322222473122,7.983837528005637,8.504895927609518,-0.07553740650288476,153806700.0,-1.0
672,2023-02-17,META,170.03959289676754,172.9964471935009,169.52013975283768,172.69677734375,24171300.0,0.0,0.0,0.439544677734375,0.0,0.439544677734375,51.60755421049191,146.9041280931902,196.95103804114427,51.536946591473246,-48.463053408526754,7.274664605313575,8.258849663150329,-0.0708372849385388,177978000.0,1.0
673,2023-02-21,META,174.1252456712348,177.98115505097448,171.69782855474108,171.89761352539062,34592600.0,0.0,0.0,-0.799163818359375,0.799163818359375,0.0,50.080356399898974,146.9041280931902,196.95103804114427,49.94011709852261,-50.05988290147738,6.576757030968622,7.922431136713987,-0.10197264214730384,143385400.0,-1.0
674,2023-02-22,META,170.88869433828123,172.57689034413363,169.51015208945014,170.93862915039062,22433200.0,0.0,0.0,-0.958984375,0.958984375,0.0,48.109144666300146,169.51015208945014,196.95103804114427,5.205652118722099,-94.7943478812779,5.883385980493927,7.514622105469976,-0.06711006270794095,120952200.0,-1.0
675,2023-02-23,META,171.81769985896884,173.50591109291338,169.20048163410323,171.85765075683594,20017800.0,0.0,0.0,0.9190216064453125,0.0,0.9190216064453125,50.27343931054164,169.20048163410323,196.56144248713773,9.711534390204044,-90.28846560979595,5.342386298023058,7.080174943980593,-0.0330486245179028,140970000.0,1.0
676,2023-02-24,META,168.4612663578512,170.53906369984782,167.48230927836815,170.20941162109375,19791300.0,0.0,0.0,-1.6482391357421875,1.6482391357421875,0.0,46.279033011290345,167.48230927836815,193.5746149490149,10.45174917521195,-89.54825082478806,4.733172932972536,6.610774541778983,-0.021590480200985973,121178700.0,-1.0
677,2023-02-27,META,171.6978373140946,172.93651334088403,168.8808187835891,169.3603057861328,19277000.0,0.0,0.0,-0.8491058349609375,0.8491058349609375,0.0,44.19191974235816,167.48230927836815,193.5746149490149,7.197510758420127,-92.80248924157988,4.137662330673351,6.116152099557857,-0.05511898232187007,101901700.0,-1.0
678,2023-02-28,META,171.71780629294318,177.3618273058982,171.68783930774697,174.7545928955078,46051100.0,0.0,0.0,5.394287109375,0.0,5.394287109375,58.05745553383341,167.48230927836815,190.62774654040405,31.419944824580888,-68.58005517541912,4.034722868851958,5.699866253416677,-0.0252952059134971,147952800.0,1.0
679,2023-03-01,META,174.4049488870432,177.66150337739745,172.86658783550513,173.23619079589844,30998400.0,0.0,0.0,-1.518402099609375,1.518402099609375,0.0,53.722391151471946,167.48230927836815,186.45217331465105,30.33169613933484,-69.66830386066516,3.791845014861991,5.318262005705741,-0.021110872756907817,116954400.0,-1.0
680,2023-03-02,META,172.19730133633573,174.82450346518633,171.24829603610632,174.3450164794922,17352000.0,0.0,0.0,1.10882568359375,0.0,1.10882568359375,56.46165495304542,167.48230927836815,181.3176115825064,49.60287133784816,-50.39712866215184,3.6431989915450913,4.983249402873611,0.01212015182854187,134306400.0,1.0
681,2023-03-03,META,178.73035736401613,186.4221929349156,176.86234429122203,185.05364990234372,45877700.0,0.0,0.0,10.708633422851534,0.0,10.708633422851534,73.76578338083121,167.48230927836815,186.4221929349156,92.77427962394694,-7.225720376053054,4.308194949598089,4.848238512218507,0.07155242123596528,180184100.0,1.0
682,2023-03-06,META,187.8007457908765,189.4589900768325,184.4443063202285,184.7040252685547,33209400.0,0.0,0.0,-0.3496246337890341,0.3496246337890341,0.0,72.67761930383028,167.48230927836815,189.4589900768325,78.36358978918206,-21.636410210817942,4.752520430977313,4.829094895970268,0.0745002299945976,146974700.0,-1.0
683,2023-03-07,META,188.79968453645608,190.15824372271936,183.81496780129967,184.3144378662109,36701500.0,0.0,0.0,-0.3895874023437784,0.3895874023437784,0.0,71.32482756173576,167.48230927836815,190.15824372271936,74.22904061197707,-25.770959388022924,5.015875797740279,4.866451076324271,0.07824918675375803,110273200.0,-1.0
684,2023-03-08,META,182.6761759374857,185.0636422285748,181.1477987643368,184.77395629882807,19432400.0,0.0,0.0,0.4595184326171591,0.0,0.4595184326171591,72.03329117551175,167.48230927836815,190.15824372271936,76.25549925139879,-23.74450074860121,5.200253483038921,4.933211557667201,0.07515700048912932,129705600.0,1.0
685,2023-03-09,META,186.15250123529717,188.72975338367613,180.1089103381748,181.4974365234375,26582800.0,0.0,0.0,-3.276519775390568,3.276519775390568,0.0,59.86470500212947,167.48230927836815,190.15824372271936,61.80617288105034,-38.19382711894967,5.030756928691773,4.952720631872116,0.06631845322086072,103122800.0,-1.0
686,2023-03-10,META,180.8181428227202,184.57416737080075,178.61049372770728,179.31973266601562,25665000.0,0.0,0.0,-2.177703857421875,2.177703857421875,0.0,52.998673419268016,167.48230927836815,190.15824372271936,52.202582507448945,-47.797417492551055,4.671057839578225,4.896388073413338,0.05880614606624235,77457800.0,-1.0
687,2023-03-13,META,177.77139597188517,183.58521972432104,174.6347245075703,180.7082672119141,24728000.0,0.0,0.0,1.388534545898466,0.0,1.388534545898466,56.6560463704943,167.48230927836815,190.15824372271936,58.32596652633494,-41.67403347366507,4.44413842552629,4.805938143835928,0.034068771628601446,102185800.0,1.0
688,2023-03-14,META,187.3811849192428,194.11404664940088,186.36226175402948,193.8143615722656,41642600.0,0.0,0.0,13.106094360351506,0.0,13.106094360351506,76.53873387253756,167.48230927836815,194.11404664940088,98.87470699729396,-1.125293002706036,5.238776769488794,4.892505868966502,0.11878678861400105,143828400.0,1.0
689,2023-03-15,META,192.74548973281563,197.57037225710383,190.63772550679263,197.5404052734375,42123600.0,0.0,0.0,3.7260437011719034,0.0,3.7260437011719034,79.60735139106727,167.48230927836815,197.57037225710383,99.90040241644168,-0.0995975835583226,6.092614416885709,5.132527578550344,0.13304302733926288,185952000.0,1.0
690,2023-03-16,META,198.0498552915601,205.5419059111595,195.88215714140333,204.71278381347656,50447100.0,0.0,0.0,7.1723785400390625,0.0,7.1723785400390625,84.19793845156319,168.8808187835891,205.5419059111595,97.73841377153435,-2.2615862284656534,7.253413331223669,5.55670472908501,0.10623478067850778,236399100.0,1.0
691,2023-03-17,META,200.34743003844625,201.68600615444805,195.2228622937947,195.40267944335935,50141100.0,0.0,0.0,-9.310104370117216,9.310104370117216,0.0,62.967816823319225,171.24829603610632,205.5419059111595,70.4340648163263,-29.5659351836737,7.3496495915985065,5.91529370158771,0.05792323236729202,186258000.0,-1.0
692,2023-03-20,META,198.26962984510757,199.14870202433428,193.4347633445935,197.600341796875,25186300.0,0.0,0.0,2.1976623535156534,0.0,2.1976623535156534,65.34760655700305,171.24829603610632,205.5419059111595,76.84243757592412,-23.157562424075888,7.513618460652992,6.234958653400767,0.07208281719258469,211444300.0,1.0
693,2023-03-21,META,202.9846307714921,203.33426591301225,197.74019510439032,201.94573974609372,31827000.0,0.0,0.0,4.345397949218722,0.0,4.345397949218722,69.77850421732741,171.24829603610632,205.5419059111595,89.51359691158733,-10.48640308841267,7.897826649139574,6.56753225254853,0.09293400320710976,243271300.0,1.0
694,2023-03-22,META,202.28537215836457,207.15020561362232,199.4583698195806,199.5982208251953,28477800.0,0.0,0.0,-2.347518920898409,2.347518920898409,0.0,64.62737491688117,174.6347245075703,207.15020561362232,76.77418715166611,-23.22581284833388,7.923840700364224,6.8387939421116695,0.09973024770198546,214793500.0,-1.0
695,2023-03-23,META,202.62501557211883,207.6596824442146,201.93574443250668,204.06349182128903,27389700.0,0.0,0.0,4.465270996093722,0.0,4.465270996093722,69.55935459632784,174.6347245075703,207.6596824442146,89.11068825636485,-10.889311743635146,8.205495680457773,7.112134289780891,0.13798681710818106,242183200.0,1.0
696,2023-03-24,META,204.9625191364457,207.35998448382333,203.33425716436332,205.7916412353516,27716400.0,0.0,0.0,1.7281494140625568,0.0,1.7281494140625568,71.34360930342424,174.6347245075703,207.6596824442146,94.34354704570191,-5.656452954298091,8.468709006893135,7.383449233203341,0.13880590196807407,269899600.0,1.0
697,2023-03-27,META,204.59292856292788,205.64181876321064,201.1465881128134,202.62501525878903,18527200.0,0.0,0.0,-3.166625976562557,3.166625976562557,0.0,63.47707743340272,174.6347245075703,207.6596824442146,84.7549626101442,-15.245037389855801,8.32831744031273,7.572422874625219,0.04545924055910744,251372400.0,-1.0
698,2023-03-28,META,199.93786335909616,200.81693556184675,197.69024803920445,200.46730041503903,19127300.0,0.0,0.0,-2.15771484375,2.15771484375,0.0,58.41318681554583,174.6347245075703,207.6596824442146,78.22137414081321,-21.778625859186782,7.952859557950433,7.6485102112902625,0.014816690983042724,232245100.0,-1.0
699,2023-03-29,META,203.34424342927085,205.50195769407705,202.32532026378743,205.13235473632807,18851100.0,0.0,0.0,4.665054321289034,0.0,4.665054321289034,65.31574831531066,174.6347245075703,207.6596824442146,92.34721899499459,-7.652781005005409,7.936697972959962,7.706147763624203,0.002049558972505583,251096200.0,1.0
700,2023-03-30,META,203.16444092279744,207.86944022336027,202.6050369097265,207.6197052001953,22608300.0,0.0,0.0,2.4873504638672443,0.0,2.4873504638672443,68.52932645064176,174.6347245075703,207.86944022336027,99.24857180876589,-0.7514281912341101,8.030202301210608,7.770958671141484,0.06252230415487858,273704500.0,1.0
701,2023-03-31,META,207.0203472312239,211.94511449881256,206.5508441752019,211.71536254882807,25440300.0,0.0,0.0,4.095657348632756,0.0,4.095657348632756,73.23994629028432,186.36226175402948,211.94511449881256,99.10192990486043,-0.8980700951395701,8.335973092170008,7.88396155534719,0.07143216769565464,299144800.0,1.0
702,2023-04-03,META,208.6186495923731,213.2637302645437,207.97932852959937,212.84417724609372,17924600.0,0.0,0.0,1.1288146972656534,0.0,1.1288146972656534,74.45588003342662,190.63772550679263,213.2637302645437,98.1457043656536,-1.8542956343464077,8.569796483554114,8.021128540988576,0.053967157285430334,317069400.0,1.0
703,2023-04-04,META,213.16382423898304,216.0108095797558,212.31471906924637,214.49241638183597,21026400.0,0.0,0.0,1.6482391357422443,0.0,1.6482391357422443,76.27233022089726,193.4347633445935,216.0108095797558,93.27431746859673,-6.7256825314032636,8.785803381635105,8.174063509117882,0.07462088336791717,338095800.0,1.0
704,2023-04-05,META,213.9230123040521,214.9619185244239,209.71748309782683,211.2558441162109,19396600.0,0.0,0.0,-3.236572265625057,3.236572265625057,0.0,65.68866746440703,193.4347633445935,216.0108095797558,78.938006176923,-21.061993823077007,8.59822594893717,8.25889599708174,0.035245659234434124,318699200.0,-1.0
705,2023-04-06,META,209.0282108064139,216.7100624261229,208.4288406640445,215.87095642089844,26104400.0,0.0,0.0,4.615112304687528,0.0,4.615112304687528,72.06609463286385,193.4347633445935,216.7100624261229,96.39486477795529,-3.6051352220447113,8.719226461742352,8.350962090013862,0.048978253562882657,344803600.0,1.0
706,2023-04-10,META,214.48243374664693,215.43142378502185,210.4367233276632,214.5223846435547,16106100.0,0.0,0.0,-1.34857177734375,1.34857177734375,0.0,67.81617319778732,197.69024803920445,216.7100624261229,88.49790151436562,-11.502098485634368,8.60756824432616,8.402283320876322,0.058716192418643676,328697500.0,-1.0
707,2023-04-11,META,215.25161409124772,215.79105029517487,213.1838159565048,213.62335205078125,16710100.0,0.0,0.0,-0.8990325927734375,0.8990325927734375,0.0,64.87334128189792,197.69024803920445,216.7100624261229,83.77108045037154,-16.228919549628447,8.350560357585522,8.391938728218161,0.06562692074220822,311987400.0,-1.0
708,2023-04-12,META,214.61228411340716,216.61016428257147,212.3546850095932,213.77317810058597,18972200.0,0.0,0.0,0.14982604980471592,0.0,0.14982604980471592,65.16402449643167,197.69024803920445,216.7100624261229,84.5588171062443,-15.441182893755695,8.065877088846321,8.326726400343793,0.042123161777012585,330959600.0,1.0
709,2023-04-13,META,215.50134149420987,220.91559495657515,215.4613905973338,220.116455078125,23310400.0,0.0,0.0,6.343276977539034,0.0,6.343276977539034,75.192589578787,197.69024803920445,220.91559495657515,96.55919077853491,-3.4408092214650874,8.254730959049198,8.312327312084873,0.06019057712214648,354270000.0,1.0
710,2023-04-14,META,217.6490746399042,221.87458701000352,217.31942257661757,221.2552490234375,21591200.0,0.0,0.0,1.1387939453125,0.0,1.1387939453125,76.58868775323214,197.69024803920445,221.87458701000352,97.43909483193305,-2.560905168066952,8.3990412786913,8.329670105406159,0.04505996333832063,375861200.0,1.0
711,2023-04-17,META,219.5570434993776,220.745784687663,216.89987434966412,218.62803649902344,15481900.0,0.0,0.0,-2.6272125244140625,2.6272125244140625,0.0,66.61003015461218,197.69024803920445,221.87458701000352,86.57581455957894,-13.424185440421061,8.207513200507151,8.305238724426356,0.027174148373541485,360379300.0,-1.0
712,2023-04-18,META,219.6769208856172,220.2063579188136,215.9808455668932,217.6590576171875,12281000.0,0.0,0.0,-0.9689788818359375,0.9689788818359375,0.0,63.11075662057212,202.32532026378743,221.87458701000352,78.43638102880779,-21.563618971192213,7.886841929613183,8.221559365463722,0.014763418160735009,348098300.0,-1.0
713,2023-04-19,META,213.24374237742904,217.09965173716856,212.70430619259537,215.47137451171875,15898100.0,0.0,0.0,-2.18768310546875,2.18768310546875,0.0,55.513529502528435,202.6050369097265,221.87458701000352,66.77030618274415,-33.22969381725584,7.3717196167208385,8.051591415715146,0.019954621436124143,332200200.0,-1.0
714,2023-04-20,META,213.2537311081367,216.52026954638853,212.5444921635962,212.84417724609372,16475400.0,0.0,0.0,-2.6271972656250284,2.6271972656250284,0.0,47.577402205311785,206.5508441752019,221.87458701000352,41.06916396821208,-58.930836031787926,6.6751311758837915,7.776299367748875,-0.014021243176887577,315724800.0,-1.0
715,2023-04-21,META,209.9872003266577,213.1838055250481,209.3578632004095,212.6643524169922,17717200.0,0.0,0.0,-0.17982482910153408,0.17982482910153408,0.0,47.046224980312516,207.97932852959937,221.87458701000352,33.7167091493828,-66.2832908506172,6.0389810652670235,7.428835707252506,-0.008661251037507145,298007600.0,-1.0
716,2023-04-24,META,213.45350918736764,213.6932602941446,210.48667117006352,212.564453125,15750900.0,0.0,0.0,-0.0998992919921875,0.0998992919921875,0.0,46.71193203497798,208.4288406640445,221.87458701000352,30.757775392649915,-69.2422246073501,5.463791962567967,7.035826958315599,-0.004956850061642815,282256700.0,-1.0
717,2023-04-25,META,210.59655542626632,211.036076258596,206.9104640844727,207.33001708984372,19198200.0,0.0,0.0,-5.234436035156278,5.234436035156278,0.0,32.67497234381577,206.9104640844727,221.87458701000352,2.8037260015768384,-97.19627399842317,4.534267396742138,6.535515046000906,-0.030140175058400276,263058500.0,-1.0
718,2023-04-26,META,212.27477527533955,213.8830694765421,208.658616922404,209.1780548095703,41992700.0,0.0,0.0,1.848037719726591,0.0,1.848037719726591,40.017696347467776,206.9104640844727,221.87458701000352,15.153515754864596,-84.8464842451354,3.9014459040709255,6.008701217614911,-0.04969369629668241,305051200.0,1.0
719,2023-04-27,META,239.63573630679187,241.43383150775867,236.51904812019345,238.30714416503903,71196500.0,0.0,0.0,29.12908935546872,0.0,29.12908935546872,79.89570598956446,206.9104640844727,241.43383150775867,90.94327240913734,-9.056727590862666,5.680296897274388,5.943020353546808,0.07706888409140178,376247700.0,1.0
720,2023-04-28,META,238.75666802245632,240.1751611365829,235.50012878095023,240.06529235839844,39554000.0,0.0,0.0,1.7581481933594034,0.0,1.7581481933594034,80.78535593143556,206.9104640844727,241.43383150775867,96.0359048044741,-3.964095195525894,7.149193766616406,6.184255036160728,0.09805355343558952,415801700.0,1.0
721,2023-05-01,META,238.36707688733765,243.7413793925649,236.20937790005388,242.9222412109375,29143900.0,0.0,0.0,2.8569488525390625,0.0,2.8569488525390625,82.25746782875365,206.9104640844727,243.7413793925649,97.77594943059307,-2.2240505694069292,8.446038886497433,6.63661180622807,0.1160676880177538,444945600.0,1.0
722,2023-05-02,META,242.9222461254936,244.6604073862913,238.7366999116016,238.98643493652344,24350100.0,0.0,0.0,-3.9358062744140625,3.9358062744140625,0.0,73.32741535287757,206.9104640844727,244.6604073862913,84.96958682983103,-15.030413170168963,9.052312414623287,7.119751927907114,0.10913310632603679,420595500.0,-1.0
723,2023-05-03,META,239.2161944350902,241.4937767147904,232.50331553409492,236.77877807617188,34463900.0,0.0,0.0,-2.2076568603515625,2.2076568603515625,0.0,68.51347780131411,206.9104640844727,244.6604073862913,79.12148040301898,-20.878519596981022,9.248265005445802,7.545454543414851,0.1124512830924409,386131600.0,-1.0
724,2023-05-04,META,235.8097925483243,237.9475237071213,232.68310522423397,233.27249145507807,17889400.0,0.0,0.0,-3.506286621093807,3.506286621093807,0.0,61.15587998319021,206.9104640844727,244.6604073862913,69.83328997300873,-30.16671002699126,9.017041133574963,7.8397718614468745,0.09690452962082441,368242200.0,-1.0
725,2023-05-05,META,231.99385846204547,234.4312595458564,229.6063921900349,232.5332794189453,26978900.0,0.0,0.0,-0.7392120361327557,0.7392120361327557,0.0,59.59895321613636,206.9104640844727,244.6604073862913,67.87510945278225,-32.12489054721775,8.674211472389004,8.006659783635302,0.09394245369051668,341263300.0,-1.0
726,2023-05-08,META,231.17472079381469,235.3702662502447,230.0259457526003,233.02276611328125,16400500.0,0.0,0.0,0.4894866943359375,0.0,0.4894866943359375,60.36981381181063,206.9104640844727,244.6604073862913,69.17176489520872,-30.82823510479128,8.34574948007699,8.074477722923639,0.12392199346756394,357663800.0,1.0
727,2023-05-09,META,231.21468610805908,235.6299995945667,230.83508398609231,233.1226501464844,16865600.0,0.0,0.0,0.09988403320315342,0.0,0.09988403320315342,60.547055442430775,206.9104640844727,244.6604073862913,69.43635875805127,-30.56364124194873,8.001245869217115,8.059831352182334,0.1144699206554558,374529400.0,1.0
728,2023-05-10,META,235.9196833094292,236.49907040077105,230.47546277322516,232.8329620361328,19119000.0,0.0,0.0,-0.2896881103515909,0.2896881103515909,0.0,59.65423644491579,206.9104640844727,244.6604073862913,68.66897188269763,-31.331028117302356,7.617055985343512,7.971276278814569,-0.02297112051796102,355410400.0,-1.0
729,2023-05-11,META,232.80299865777897,237.9575333494494,232.05379356570884,235.5400848388672,20449000.0,0.0,0.0,2.707122802734375,0.0,2.707122802734375,65.18914311555321,206.9104640844727,244.6604073862913,75.84016888580403,-24.159831114195974,7.444995145607237,7.866020052173104,-0.01884990318706914,375859400.0,1.0
730,2023-05-12,META,236.48908194979307,236.7088499885896,231.20468034775263,233.5621795654297,16155300.0,0.0,0.0,-1.9779052734375,1.9779052734375,0.0,58.43136632409975,206.9104640844727,244.6604073862913,70.60067684836244,-29.399323151637564,7.067687824053195,7.706353606549123,-0.038531101964353054,359704100.0,-1.0
731,2023-05-15,META,236.6688957339195,240.00535213757115,235.0805845722707,238.6068420410156,20653200.0,0.0,0.0,5.044662475585909,0.0,5.044662475585909,68.14841111410169,208.658616922404,244.6604073862913,83.18537698465882,-16.814623015341184,7.093634716891444,7.5838098286175875,-0.0015883449435474262,380357300.0,1.0
732,2023-05-16,META,235.54007678083985,239.38600221894072,235.27037393160532,238.5668792724609,18163800.0,0.0,0.0,-0.0399627685546875,0.0399627685546875,0.0,68.00311011827725,229.6063921900349,244.6604073862913,59.522240183830036,-40.477759816169964,7.029929035747244,7.47303367004352,0.007551779812436488,362193500.0,-1.0
733,2023-05-17,META,238.1972599750754,243.58154641799055,237.88759098786204,242.2329864501953,21193100.0,0.0,0.0,3.6661071777344034,0.0,3.6661071777344034,73.89477230921057,229.6063921900349,244.6604073862913,83.87525916208965,-16.124740837910355,7.192152777760555,7.416857491586927,0.03841213740730676,383386600.0,1.0
734,2023-05-18,META,241.0442580975845,246.82811478384625,240.934374072814,246.58837890625,22943300.0,0.0,0.0,4.3553924560546875,0.0,4.3553924560546875,79.15594276021349,229.6063921900349,246.82811478384625,98.60794484239112,-1.3920551576088882,7.584503163645081,7.450386625998559,0.06044338910295166,406329900.0,1.0
735,2023-05-19,META,247.2077162051814,248.42642438819297,243.15202169955336,245.3796539306641,21599800.0,0.0,0.0,-1.208724975585909,1.208724975585909,0.0,74.35721502389707,229.6063921900349,248.42642438819297,83.8110242030985,-16.18897579690151,7.70908961177858,7.502127223154564,0.053028671934036264,384730100.0,-1.0
736,2023-05-22,META,245.14988917491408,253.30124390203136,244.8601880152773,248.0568084716797,27738500.0,0.0,0.0,2.6771545410155966,0.0,2.6771545410155966,77.797115220616,229.6063921900349,253.30124390203136,77.86677252047764,-22.133227479522358,7.932287524622808,7.588159283448213,0.06406137848815341,412468600.0,1.0
737,2023-05-23,META,246.5484029880759,251.343318503878,246.38856891427204,246.47848510742188,17748100.0,0.0,0.0,-1.5783233642578125,1.5783233642578125,0.0,71.29149338971223,229.6063921900349,253.30124390203136,71.20573330638236,-28.794266693617647,7.890908750208979,7.6487091768003665,0.058606491761125534,394720500.0,-1.0
738,2023-05-24,META,245.02003442912772,249.3254639604868,244.69038235635745,248.9458770751953,17724300.0,0.0,0.0,2.4673919677734375,0.0,2.4673919677734375,75.05429386974494,229.6063921900349,253.30124390203136,81.61893191071978,-18.381068089280216,7.965297357295668,7.712026812899427,0.05691512018219336,412444800.0,1.0
739,2023-05-25,META,253.1314191217841,255.34906739717528,248.90590670196747,252.42218017578125,22371400.0,0.0,0.0,3.4763031005859375,0.0,3.4763031005859375,79.43593623483268,230.0259457526003,255.34906739717528,88.44183879667513,-11.558161203324865,8.209994699604437,7.81162039024043,0.08074937751241595,434816200.0,1.0
740,2023-05-26,META,252.6619080516553,262.03197091431946,252.4421552564499,261.76226806640625,25727200.0,0.0,0.0,9.340087890625,0.0,9.340087890625,86.68588203281953,230.47546277322516,262.03197091431946,99.14533367663076,-0.8546663233692499,9.052927983181576,8.059881908828661,0.09704426674156452,460543400.0,1.0
741,2023-05-30,META,264.9688778698144,268.3652683222769,261.0130833656632,262.24176025390625,23816500.0,0.0,0.0,0.4794921875,0.0,0.4794921875,86.95824025612512,230.47546277322516,268.3652683222769,83.83863949778464,-16.161360502215366,9.648405575071678,8.377586642077265,0.09923792042568857,484359900.0,1.0
742,2023-05-31,META,259.7244241496044,264.71912461401985,258.1760791997285,264.4394226074219,25473700.0,0.0,0.0,2.197662353515625,0.0,2.197662353515625,88.23139295160183,231.20468034775263,268.3652683222769,89.43545856285583,-10.564541437144166,10.180239810992731,8.73811727586036,0.09167387349943912,509833600.0,1.0
743,2023-06-01,META,265.6181654139683,273.7095862881461,265.6081967429669,272.321044921875,25609500.0,0.0,0.0,7.881622314453125,0.0,7.881622314453125,91.61760959691998,231.20468034775263,273.7095862881461,96.73322094108777,-3.266779058912226,11.109435673933831,9.212380955475053,0.10435473938294648,535443100.0,1.0
744,1.0,1.0,1.0,1.0,1.0,1.0,1.0,1.0,1.0,1.0,1.0,1.0,1.0,1.0,1.0,1.0,1.0,1.0,1.0,1.0,1.0,1.0
745,2023-06-05,META,270.0134844708905,275.27791806735945,269.2742785860161,271.10235595703125,20742900.0,0.0,0.0,-1.21868896484375,1.21868896484375,0.0,86.49430403042558,235.27037393160532,275.27791806735945,89.56306316588784,-10.436936834112156,11.951345543132078,10.15992511602024,0.09290431344069572,514700200.0,-1.0
746,2023-06-06,META,269.8536997903737,276.2768774726684,269.40416454038035,270.8326416015625,19419000.0,0.0,0.0,-0.26971435546875,0.26971435546875,0.0,85.2765487853966,237.88759098786204,276.2768774726684,85.81834576878474,-14.181654231215262,11.982072491835709,10.524354591183334,0.09880844765629915,495281200.0,-1.0
747,2023-06-07,META,271.3820716365481,273.9593236929742,262.5214473009429,263.32061767578125,26163600.0,0.0,0.0,-7.51202392578125,7.51202392578125,0.0,58.71209524239786,240.934374072814,276.2768774726684,63.340854352324925,-36.65914564767508,11.270480244385027,10.673579721823673,0.05774243289132275,469117600.0,-1.0
748,2023-06-08,META,260.3437662522802,267.366313997046,258.6056202184132,264.299560546875,20899400.0,0.0,0.0,0.97894287109375,0.0,0.97894287109375,60.55949966406993,243.15202169955336,276.2768774726684,63.84190467777226,-36.15809532222774,10.66259936480489,10.671383650419918,0.047053631985995104,490017000.0,1.0
749,2023-06-09,META,262.20180620756054,267.66600972780736,261.42263415555243,264.669189453125,16938500.0,0.0,0.0,0.36962890625,0.0,0.36962890625,61.313642246894396,244.69038235635745,276.2768774726684,63.25110469901646,-36.74889530098354,10.094305958512365,10.555968112038409,0.011105196360773117,506955500.0,1.0
750,2023-06-12,META,266.88683342654895,271.461965559552,265.04875686033773,270.7626953125,15442500.0,0.0,0.0,6.093505859375,0.0,6.093505859375,71.63162365082239,244.69038235635745,276.2768774726684,82.54259568887426,-17.457404311125742,10.020028294159971,10.448780148462722,0.0324926703143833,522398000.0,1.0
751,2023-06-13,META,274.588664567508,275.42777060856514,268.80479274728464,271.0324401855469,16164000.0,0.0,0.0,0.269744873046875,0.0,0.269744873046875,72.0128903019851,244.69038235635745,276.2768774726684,83.39658367346576,-16.603416326534248,9.869156697428934,10.332855458255965,0.02493205254011155,538562000.0,1.0
752,2023-06-14,META,271.60182826122275,274.6985180671888,268.0356049211801,273.0602722167969,19175100.0,0.0,0.0,2.02783203125,0.0,2.02783203125,74.93495311830566,248.90590670196747,276.2768774726684,88.24811409570205,-11.75188590429795,9.800220096445003,10.226328385893773,0.0027145433990749535,557737100.0,1.0
753,2023-06-15,META,272.0113823963807,283.6889948343277,271.13234069865297,281.5312805175781,25973500.0,0.0,0.0,8.47100830078125,0.0,8.47100830078125,83.32607946546631,252.4421552564499,283.6889948343277,93.09461582067591,-6.905384179324081,10.310176830621856,10.24309807483939,0.03382124065492409,583710600.0,1.0
754,2023-06-16,META,284.4482044749413,287.54492500174155,279.83310591210727,280.7021789550781,43102500.0,0.0,0.0,-0.8291015625,0.8291015625,0.0,80.29053483130971,258.1760791997285,287.54492500174155,76.7006640547161,-23.299335945283893,10.526087094636921,10.299695878798897,0.035410326716483365,540608100.0,-1.0
755,2023-06-20,META,278.4345853111735,284.4981285551348,275.9272359025263,284.02862548828125,20701600.0,0.0,0.0,3.326446533203125,0.0,3.326446533203125,83.1347877149897,258.1760791997285,287.54492500174155,88.0271103019674,-11.972889698032597,10.840614329277457,10.407879568894609,0.04872375725719258,561309700.0,1.0
756,2023-06-21,META,283.22950327305875,283.6990063692059,278.0649692154401,281.3415222167969,20556200.0,0.0,0.0,-2.687103271484375,2.687103271484375,0.0,73.27833430411616,258.6056202184132,287.54492500174155,78.5640918764628,-21.43590812353721,10.74916501332541,10.47613665778077,0.0684371193569211,540753500.0,-1.0
757,2023-06-22,META,278.78419302449805,284.9576660850152,277.49558222947337,284.5780639648437,17563100.0,0.0,0.0,3.236541748046818,0.0,3.236541748046818,77.05845230348956,258.6056202184132,287.54492500174155,89.74798786940094,-10.252012130599052,10.813175462939967,10.54354441881261,0.07672545264929487,558316600.0,1.0
758,2023-06-23,META,281.2116321048835,289.36298682834104,278.65434793500253,288.4239807128906,50988400.0,0.0,0.0,3.845916748046932,0.0,3.845916748046932,80.78530263056042,258.6056202184132,289.36298682834104,96.94705295365787,-3.052947046342126,11.046863768753497,10.644208288800789,0.08975276385154296,609305000.0,1.0
759,2023-06-26,META,288.39403446610635,289.48287557502925,277.3057926668796,278.17486572265625,24232700.0,0.0,0.0,-10.249114990234375,10.249114990234375,0.0,53.87407711977945,258.6056202184132,289.48287557502925,63.377542071756565,-36.622457928243435,10.286541468986456,10.572674924837923,0.027375153736010516,585072300.0,-1.0
760,2023-06-27,META,281.7111216466164,289.0433386943294,280.35254718937915,286.7457580566406,26108300.0,0.0,0.0,8.570892333984375,0.0,8.570892333984375,65.09397873817832,258.6056202184132,289.48287557502925,91.13548958035175,-8.864510419648258,10.257281434424101,10.509596226755159,0.0579757827525611,611180600.0,1.0
761,2023-06-28,META,284.518137296796,289.2431046369136,283.75893303697427,284.9876403808594,16722100.0,0.0,0.0,-1.75811767578125,1.75811767578125,0.0,61.5503800937698,258.6056202184132,289.48287557502925,85.44159724608849,-14.558402753911508,9.977225540468453,10.403122089497819,0.043680349643073546,594458500.0,-1.0
762,2023-06-29,META,284.19845114049326,286.2662644107655,280.3924918962001,281.2315979003906,15395700.0,0.0,0.0,-3.75604248046875,3.75604248046875,0.0,54.26793132913586,261.42263415555243,289.48287557502925,70.5944166648853,-29.4055833351147,9.344501049019982,10.191397881402253,-0.0010644736053363468,579062800.0,-1.0
763,2023-06-30,META,284.4581940328205,288.74362513356766,284.11855805537493,286.67584228515625,19676000.0,0.0,0.0,5.444244384765625,0.0,5.444244384765625,61.82249323831509,265.04875686033773,289.48287557502925,88.51182920632526,-11.488170793674737,9.17655575236273,9.98842945559435,0.021281143425089466,598738800.0,1.0
764,2023-07-03,META,286.39612980787444,289.0932497014485,284.5480845842655,285.7168273925781,8629300.0,0.0,0.0,-0.959014892578125,0.959014892578125,0.0,59.81419437886869,268.0356049211801,289.48287557502925,82.44043149716472,-17.559568502835273,8.863899703765242,9.763523505228529,0.005943773805878294,590109500.0,-1.0
765,2023-07-05,META,287.34510491159193,297.8040086592836,286.056463685996,294.0579833984375,33865500.0,0.0,0.0,8.341156005859375,0.0,8.341156005859375,69.69418604025216,268.0356049211801,297.8040086592836,87.41610301377627,-12.583896986223738,9.183280787465662,9.647474961675956,0.04519937576736921,623975000.0,1.0
766,2023-07-06,META,295.5764022719073,297.8040191952864,291.0012395197329,291.6805114746094,47600500.0,0.0,0.0,-2.377471923828125,2.377471923828125,0.0,64.48045024188343,271.13234069865297,297.8040191952864,77.0411610148572,-22.958838985142798,9.139208428350685,9.545821655010903,0.024957817938641602,576374500.0,-1.0
767,2023-07-07,META,291.87032154293354,295.88608039914243,288.3540632398264,290.2220764160156,25546200.0,0.0,0.0,-1.45843505859375,1.45843505859375,0.0,61.237859935656324,275.9272359025263,297.8040191952864,65.34251549778824,-34.65748450221176,8.884190765123265,9.413495477033376,0.0062342101328769495,550828300.0,-1.0
768,2023-07-10,META,295.2367444639734,297.81402708189887,286.7457533234099,293.7882995605469,37058300.0,0.0,0.0,3.56622314453125,0.0,3.56622314453125,66.05422184220609,275.9272359025263,297.81402708189887,81.60658870293382,-18.393411297066184,8.867617780781757,9.304319937783053,0.056128125728862166,587886600.0,1.0
769,2023-07-11,META,293.5884848302945,299.8618273435279,291.590604660663,297.9738464355469,27585900.0,0.0,0.0,4.185546875,0.0,4.185546875,70.94351468125541,277.3057926668796,299.8618273435279,91.62981909255697,-8.370180907443023,9.08745286389535,9.260946523005513,0.03915694674963022,615472500.0,1.0
770,2023-07-12,META,301.43016405738774,309.1220147377832,299.7819190502263,309.0121154785156,36677100.0,0.0,0.0,11.03826904296875,0.0,11.03826904296875,79.7978298615508,277.3057926668796,309.1220147377832,99.65458105295255,-0.3454189470474469,10.036638343865263,9.416084887177464,0.08430005969925491,652149600.0,1.0
771,2023-07-13,META,313.2875887089684,315.9048068885243,309.9611315955802,313.07781982421875,30281000.0,0.0,0.0,4.065704345703125,0.0,4.065704345703125,82.11417655248732,277.3057926668796,315.9048068885243,92.67601227307946,-7.323987726920531,10.990241543562831,9.730916218454539,0.11323842043918453,682430600.0,1.0
772,2023-07-14,META,311.4595516495654,314.5462729928491,307.034223705158,308.5426330566406,22576000.0,0.0,0.0,-4.535186767578125,4.535186767578125,0.0,71.55451774923765,277.3057926668796,315.9048068885243,80.92652369408104,-19.07347630591896,11.250351402464275,10.034803255256486,0.076277061217225,659854600.0,-1.0
773,2023-07-17,META,307.21404936508816,311.37961254391985,304.38703178758067,310.290771484375,25323100.0,0.0,0.0,1.748138427734375,0.0,1.748138427734375,73.09344600315447,280.35254718937915,315.9048068885243,84.20906166961785,-15.790938330382149,11.465379656781863,10.320918535561562,0.0860080392046072,685177700.0,1.0
774,2023-07-18,META,310.5504954649614,313.8669838311787,307.29394106443925,311.71923828125,20764600.0,0.0,0.0,1.428466796875,0.0,1.428466796875,74.3993129519192,280.3924918962001,315.9048068885243,88.21375455759781,-11.786245442402185,11.617137332498089,10.580162294948869,0.06006045025100426,705942300.0,1.0
775,2023-07-19,META,312.6982267920201,318.3422324135454,310.1908773175214,315.6750793457031,21763700.0,0.0,0.0,3.955841064453125,0.0,3.955841064453125,77.83644942488725,280.3924918962001,318.3422324135454,92.97188062030828,-7.02811937969172,11.919203482060482,10.847970532371193,0.08226318498204654,727706000.0,1.0
776,2023-07-20,META,313.1677138296021,315.2055601205305,301.8996709916018,302.1993408203125,23836900.0,0.0,0.0,-13.475738525390625,13.475738525390625,0.0,50.94928928687661,284.11855805537493,318.3422324135454,52.83121436848588,-47.16878563151412,10.945071623334059,10.867390750563766,0.041269308497153157,703869100.0,-1.0
777,2023-07-21,META,304.2471899879976,305.1362308141996,290.891365886029,293.9481201171875,42089700.0,0.0,0.0,-8.251220703125,8.251220703125,0.0,40.95443641423513,284.5480845842655,318.3422324135454,27.815572034568763,-72.18442796543124,9.398930387831626,10.573698678017339,0.0005439990526501237,661779400.0,-1.0
778,2023-07-24,META,295.46649688492374,297.2046428761555,287.9944140804329,291.3009033203125,24915700.0,0.0,0.0,-2.647216796875,2.647216796875,0.0,38.181675220288156,286.056463685996,318.3422324135454,16.243812184163467,-83.75618781583654,7.869286261401669,10.032816194694206,-0.02239439197452442,636863700.0,-1.0
779,2023-07-25,META,294.87713605403394,297.98382519002786,291.5506483873013,294.15789794921875,19585600.0,0.0,0.0,2.85699462890625,0.0,2.85699462890625,42.9883316869688,286.7457533234099,318.3422324135454,23.458767683146583,-76.54123231685341,6.80907264970557,9.38806748569648,-0.04807001662797139,656449300.0,1.0
780,2023-07-26,META,300.8707888952984,301.4501607739523,291.5906262833323,298.2535705566406,47256900.0,0.0,0.0,4.095672607421875,0.0,4.095672607421875,49.48525490625342,286.7457533234099,318.3422324135454,36.42120123701858,-63.57879876298143,6.227539101156935,8.755961808788571,-0.04735004631085449,703706200.0,1.0
781,2023-07-27,META,324.7753984726097,325.00516566890553,309.5115950562175,311.3796081542969,64229200.0,0.0,0.0,13.12603759765625,0.0,13.12603759765625,64.46141402125517,286.7457533234099,325.00516566890553,64.38639100996852,-35.61360899003149,6.748026323167949,8.354374711664446,0.009194758823282134,767935400.0,1.0
782,2023-07-28,META,316.5441491792336,325.85427838691294,313.91693179366524,325.1350402832031,39220300.0,0.0,0.0,13.75543212890625,0.0,13.75543212890625,73.83954150764686,287.9944140804329,325.85427838691294,98.100262330875,-1.8997376691250023,8.176197100192951,8.318739189370147,0.04783986558097042,807155700.0,1.0
783,2023-07-31,META,323.34693066647634,325.3148439270624,317.2533898226389,318.2623291015625,25799600.0,0.0,0.0,-6.872711181640625,6.872711181640625,0.0,64.08953567773781,287.9944140804329,325.85427838691294,79.94723588047566,-20.052764119524344,8.653715223525012,8.38573439620112,0.020990333661758065,781356100.0,-1.0
784,2023-08-01,META,317.20344720532853,323.7964579481471,314.3264948458999,322.3679504394531,22817900.0,0.0,0.0,4.105621337890625,0.0,4.105621337890625,67.08528005791939,287.9944140804329,325.85427838691294,90.79149381192289,-9.20850618807711,9.256730616539755,8.559933640268847,0.021201772112078743,804174000.0,1.0
785,2023-08-02,META,317.6629591691094,318.05256045005893,310.32074316673896,313.97686767578125,20461100.0,0.0,0.0,-8.391082763671875,8.391082763671875,0.0,56.05715239558223,287.9944140804329,325.85427838691294,68.62796280783616,-31.372037192163845,8.954322553084296,8.638811422831937,0.038972708621729524,783712900.0,-1.0
786,2023-08-03,META,309.6015081547545,315.61514726694526,309.6015081547545,312.8580627441406,15180200.0,0.0,0.0,-1.118804931640625,1.118804931640625,0.0,54.67440488139475,287.9944140804329,325.85427838691294,65.67284146195978,-34.32715853804022,8.526101058803533,8.616269350026256,0.06433088471331039,768532700.0,-1.0
787,2023-08-04,META,314.6261623552987,318.0725178614773,309.8712282546688,310.4006652832031,17600200.0,0.0,0.0,-2.4573974609375,2.4573974609375,0.0,51.45756095220308,287.9944140804329,325.85427838691294,59.18206949023643,-40.81793050976357,7.897406574501133,8.47249679492123,0.06556712233016548,750932500.0,-1.0
788,2023-08-07,META,312.89803006224554,316.73395652979167,310.13094637242665,316.2244873046875,16236500.0,0.0,0.0,5.823822021484375,0.0,5.823822021484375,58.18511811410821,287.9944140804329,325.85427838691294,74.56464448929044,-25.435355510709556,7.779414534376599,8.333880342812304,0.07501613762306047,767169000.0,1.0
789,2023-08-08,META,314.06676867222666,317.5530904325439,309.7813070073531,312.30865478515625,15183500.0,0.0,0.0,-3.91583251953125,3.91583251953125,0.0,52.53628102328047,287.9944140804329,325.85427838691294,64.22167947538514,-35.77832052461485,7.28594491967749,8.124293258185341,0.047124613469955,751985500.0,-1.0
790,2023-08-09,META,312.548389251749,313.29759434085844,302.5290210794671,304.8865051269531,19955800.0,0.0,0.0,-7.422149658203125,7.422149658203125,0.0,43.33515482179618,287.9944140804329,325.85427838691294,44.61741043173526,-55.38258956826474,6.224217264072706,7.744278059362814,-0.020852691882527696,732029700.0,-1.0
791,2023-08-10,META,307.6136351346906,312.00896573915,303.54794136934106,305.4159545898437,14358900.0,0.0,0.0,0.5294494628905682,0.0,0.5294494628905682,44.14038914538878,287.9944140804329,325.85427838691294,46.01585565225854,-53.98414434774147,5.363683059763616,7.268159059442975,-0.06064890968436831,746388600.0,1.0
792,2023-08-11,META,302.24931949536074,304.39703465681515,300.0416398802779,301.3203125,13967800.0,0.0,0.0,-4.095642089843693,4.095642089843693,0.0,39.171856789065934,291.5506483873013,325.85427838691294,28.47997169048672,-71.52002830951328,4.3016351949762,6.67485428654962,-0.053232868148074264,732420800.0,-1.0
793,2023-08-14,META,300.6610090138008,305.885446343389,297.9338915049724,305.865478515625,15641900.0,0.0,0.0,4.545166015625,0.0,4.545166015625,46.83479182234066,291.5906262833323,325.85427838691294,41.661794221874366,-58.33820577812564,3.7830998946134287,6.096503408162382,-0.05119141621036427,748062700.0,1.0
794,2023-08-15,META,305.8155358088454,306.9043768559216,299.7119959662425,301.6299743652344,11623600.0,0.0,0.0,-4.235504150390625,4.235504150390625,0.0,41.247611856745145,297.9338915049724,325.85427838691294,13.237935691545449,-86.76206430845454,2.995854878455532,5.476373702221013,-0.03932421328343372,736439100.0,-1.0
795,2023-08-16,META,299.8818279842352,300.7608696581035,293.96808922270617,293.97808837890625,18547700.0,0.0,0.0,-7.651885986328125,7.651885986328125,0.0,33.03305572283537,293.96808922270617,325.85427838691294,0.031358893810067845,-99.96864110618993,1.7345232930807128,4.728003620392953,-0.060346772589570996,717891400.0,-1.0
796,2023-08-17,META,292.73939680172515,295.73621723164314,284.6480060291338,284.787841796875,23950100.0,0.0,0.0,-9.19024658203125,9.19024658203125,0.0,25.88819658585321,284.6480060291338,325.3148439270624,0.34385699741933057,-99.65614300258066,-0.006587288855826046,3.7810854385431973,-0.08251536272629933,693941300.0,-1.0
797,2023-08-18,META,278.734269915239,285.38721499824857,274.08920429678534,282.9497985839844,34061200.0,0.0,0.0,-1.838043212890625,1.838043212890625,0.0,24.65744756338978,274.08920429678534,323.7964579481471,17.82555590245588,-82.17444409754413,-1.5172539275793042,2.721417565318697,-0.10522489578311,659880100.0,-1.0
798,2023-08-21,META,283.1495972539756,290.192113106,281.5512869195119,289.5927429199219,20181500.0,0.0,0.0,6.6429443359375,0.0,6.6429443359375,37.123018843564616,274.08920429678534,318.0725178614773,35.24868266310465,-64.75131733689534,-2.1536148310675003,1.7464110860414574,-0.0727354542283214,680061600.0,1.0
799,2023-08-22,META,292.239932041294,292.5895671948522,286.4460912989145,287.2951965332031,12999900.0,0.0,0.0,-2.29754638671875,2.29754638671875,0.0,34.823704203991426,274.08920429678534,318.0725178614773,30.025005317059655,-69.97499468294033,-2.8109248151189377,0.8349439058093782,-0.05769789183166729,667061700.0,-1.0
800,2023-08-23,META,288.19422457096584,297.08478554040653,287.36511768500947,293.9281311035156,18287000.0,0.0,0.0,6.6329345703125,0.0,6.6329345703125,45.97103945545142,274.08920429678534,318.0725178614773,45.10557572600937,-54.89442427399064,-2.764756949307582,0.11500373478598588,-0.037613698019658304,685348700.0,1.0
801,2023-08-24,META,298.1836216867542,299.14259565279616,286.336206660688,286.4460754394531,18360900.0,0.0,0.0,-7.4820556640625,7.4820556640625,0.0,37.600741369077625,274.08920429678534,317.5530904325439,28.430203190003184,-71.56979680999682,-3.2939353341423043,-0.5667840789996724,-0.0493635392089502,666987800.0,-1.0
802,2023-08-25,META,285.82672481199694,288.084339107346,275.7374240889519,285.1973876953125,23701400.0,0.0,0.0,-1.248687744140625,1.248687744140625,0.0,36.327040514831424,274.08920429678534,317.5530904325439,25.557271533040037,-74.44272846695996,-3.770606109725179,-1.2075484851447742,-0.06757248618123046,643286400.0,-1.0
803,2023-08-28,META,287.69474768799864,291.14110321377075,285.4970672824001,289.9523620605469,14239300.0,0.0,0.0,4.754974365234375,0.0,4.754974365234375,44.576197824021946,274.08920429678534,313.29759434085844,40.458579773181675,-59.54142022681833,-3.721783180413752,-1.71039542419857,-0.0387150260157747,657525700.0,1.0
804,2023-08-29,META,288.27413340309954,298.83293804387296,287.87456344246164,297.6741638183594,20844500.0,0.0,0.0,7.7218017578125,0.0,7.7218017578125,55.4025660658506,274.08920429678534,312.00896573915,62.19701449710193,-37.80298550289806,-3.025135657763542,-1.9733434709115645,0.012572622197234207,678370200.0,1.0
805,2023-08-30,META,296.855044781663,297.9738528230026,293.1189880544072,294.7872314453125,17717000.0,0.0,0.0,-2.886932373046875,2.886932373046875,0.0,51.09684004487165,274.08920429678534,306.9043768559216,63.07456439921872,-36.92543560078127,-2.6751507122079374,-2.1137049191708392,0.03511171539257485,660653200.0,-1.0
806,2023-08-31,META,295.4864845749976,300.7808856682888,295.3466488061304,295.576416015625,17229900.0,0.0,0.0,0.7891845703125,0.0,0.7891845703125,52.266947118279035,274.08920429678534,306.9043768559216,65.4795024469779,-34.52049755302208,-2.3075051900288486,-2.152464973342441,0.044624938751786525,677883100.0,1.0
807,2023-09-01,META,299.0527087536433,301.4201920388349,294.1579081005372,296.0658874511719,12819800.0,0.0,0.0,0.489471435546875,0.0,0.489471435546875,53.070530597629144,274.08920429678534,306.9043768559216,66.97110342717937,-33.028896572820635,-1.9541214034024392,-2.1127962593544405,0.02235257854179018,690702900.0,1.0
808,2023-09-05,META,296.7051911281462,301.07058517284923,295.19681223796096,299.8318786621094,14956000.0,0.0,0.0,3.7659912109375,0.0,3.7659912109375,59.172431626953525,274.08920429678534,301.4201920388349,94.18859870080051,-5.811401299199496,-1.3545642496999903,-1.9611498574235504,0.0436369360859028,705658900.0,1.0
809,2023-09-06,META,301.390221803137,302.9785329711958,295.34664613620185,298.8529357910156,15418100.0,0.0,0.0,-0.97894287109375,0.97894287109375,0.0,56.95142397235402,274.08920429678534,302.9785329711958,85.7193040839521,-14.280695916047904,-0.9474812743213192,-1.7584161408031043,0.016755132178095433,690240800.0,-1.0
810,2023-09-07,META,297.6841513059555,306.72454706259697,291.9102787181553,298.3534545898437,33748700.0,0.0,0.0,-0.49948120117193184,0.49948120117193184,0.0,55.72015576201097,274.08920429678534,306.72454706259697,74.34961068794802,-25.65038931205198,-0.6575887011229611,-1.5382506528670756,0.041569356927382506,656492100.0,-1.0
811,2023-09-08,META,298.9028566991322,304.92646425768805,296.4654404264438,297.57427978515625,17548000.0,0.0,0.0,-0.7791748046874432,0.7791748046874432,0.0,53.63305102918806,275.7374240889519,306.72454706259697,70.4707426848787,-29.52925731512131,-0.4851272965387352,-1.3276259816014078,0.04339763484463077,638944100.0,-1.0
812,2023-09-11,META,301.09053338964816,308.7124510832195,300.9606663015168,307.2340087890625,19489300.0,0.0,0.0,9.65972900390625,0.0,9.65972900390625,69.80942683995222,275.7374240889519,308.7124510832195,95.51647889654797,-4.483521103452032,0.42609604389707556,-0.9768815765017111,0.05960167596395349,658433400.0,1.0
813,2023-09-12,META,306.00530414138893,308.3328516211851,299.91179398485224,301.3402709960937,13480400.0,0.0,0.0,-5.893737792968807,5.893737792968807,0.0,56.04435815500382,275.7374240889519,308.7124510832195,77.64314161620736,-22.35685838379264,0.6650066006792485,-0.6485039410655191,0.012315839341607626,644953000.0,-1.0
814,2023-09-13,META,302.0395133600089,306.8544119482132,301.00063760758826,304.7366638183594,13210900.0,0.0,0.0,3.396392822265682,0.0,3.396392822265682,61.139411073107446,275.7374240889519,308.7124510832195,87.94303560221111,-12.056964397788885,1.115545771793279,-0.2956939984937594,0.033751232454220625,658163900.0,1.0
815,2023-09-14,META,306.4148851077922,312.53839297007653,304.70670602477566,311.3896179199219,19343100.0,0.0,0.0,6.6529541015625,0.0,6.6529541015625,69.20680619159245,275.7374240889519,312.53839297007653,96.87841085416676,-3.1215891458332394,1.9865388609205183,0.16075257338909632,0.053499538689382176,677507000.0,1.0
816,2023-09-15,META,311.27971016318224,311.6693114353881,298.4333551003917,299.99169921875,28106400.0,0.0,0.0,-11.397918701171875,11.397918701171875,0.0,49.069725415394124,285.4970672824001,312.53839297007653,53.601780118922015,-46.39821988107799,1.7370675647152325,0.4760155716543236,0.01325992602989623,649400600.0,-1.0
817,2023-09-18,META,297.8739449651032,303.2782144574207,297.4843437008989,302.22930908203125,14234200.0,0.0,0.0,2.23760986328125,0.0,2.23760986328125,52.21899408542025,287.87456344246164,312.53839297007653,58.20160905465755,-41.79839094534244,1.7003158092894637,0.7208756191813518,0.007995915679878784,663634800.0,1.0
818,2023-09-19,META,302.15942229864896,305.84551382694605,299.4922387309708,304.7466735839844,15924400.0,0.0,0.0,2.517364501953125,0.0,2.517364501953125,55.76931040192168,291.9102787181553,312.53839297007653,62.22767000931037,-37.77232999068963,1.8529600857677906,0.9472925124986397,0.01972119757622237,679559200.0,1.0
819,2023-09-20,META,304.7266584846232,307.73347787354083,299.1126201260224,299.3523864746094,19379500.0,0.0,0.0,-5.394287109375,5.394287109375,0.0,47.113748275462804,291.9102787181553,312.53839297007653,36.07749921086911,-63.9225007891309,1.5211237044223367,1.0620587508833792,0.0033481492149602943,660179700.0,-1.0
820,2023-09-21,META,295.3865979579988,299.94176234732834,292.9591503610643,295.41656494140625,21300500.0,0.0,0.0,-3.935821533203125,3.935821533203125,0.0,41.66917162115426,291.9102787181553,312.53839297007653,16.997609090343126,-83.00239090965688,0.929834783661363,1.035613957438976,-0.007251012571744542,638879200.0,-1.0
821,2023-09-22,META,298.9827685361592,305.0563415946588,297.9538614222837,298.76300048828125,25369600.0,0.0,0.0,3.346435546875,0.0,3.346435546875,47.60892905350932,291.9102787181553,312.53839297007653,33.22030160603602,-66.77969839396398,0.722929747419812,0.9730771154351432,-0.027571844452276117,664248800.0,1.0
822,2023-09-25,META,295.3266678081227,300.6310373364275,293.3887215621064,300.5111389160156,18987000.0,0.0,0.0,1.748138427734375,0.0,1.748138427734375,50.63862519768652,291.9102787181553,312.53839297007653,41.69484468052748,-58.30515531947251,0.6920386860491021,0.9168694295579349,-0.0027514811655851013,683235800.0,1.0
823,2023-09-26,META,297.3445174894917,299.9817035336785,295.69627240122094,298.64312744140625,19417200.0,0.0,0.0,-1.868011474609375,1.868011474609375,0.0,47.268360843247535,291.9102787181553,312.53839297007653,32.639186699403986,-67.360813300596,0.5109347437469296,0.835682492395734,-0.019996072348502314,663818600.0,-1.0
824,2023-09-27,META,300.13155750963307,300.9806321845803,286.4860324368262,297.4244079589844,36429800.0,0.0,0.0,-1.218719482421875,1.218719482421875,0.0,45.01311817154347,286.4860324368262,312.53839297007653,41.98612063654525,-58.01387936345475,0.26600184445607056,0.7217463628078014,-0.04484802690027012,627388800.0,-1.0
825,2023-09-28,META,298.62314916907724,306.0053004885524,296.3855331510331,303.6378173828125,22167100.0,0.0,0.0,6.213409423828125,0.0,6.213409423828125,57.063991707457156,286.4860324368262,312.53839297007653,65.83581907710698,-34.16418092289303,0.5667278032123022,0.6907426508887016,0.012154063507616497,649555900.0,1.0
826,2023-09-29,META,307.0542295053573,310.3107841636394,299.0427099573478,299.8918151855469,25356600.0,0.0,0.0,-3.746002197265625,3.746002197265625,0.0,49.5151020468329,286.4860324368262,312.53839297007653,51.45707519136716,-48.54292480863284,0.4970546405484697,0.6520050488206552,-0.007734173444607695,624199300.0,-1.0
827,2023-10-02,META,302.41911928925936,306.8544158185772,301.3103103995463,306.49481201171875,16265600.0,0.0,0.0,6.602996826171875,0.0,6.602996826171875,60.218526777694734,286.4860324368262,312.53839297007653,76.80217517854314,-23.197824821456855,0.9635374994135191,0.714311538939228,0.005736365904097651,640464900.0,1.0
828,2023-10-03,META,303.93752112559207,306.4448400181264,299.3224227937016,300.6210327148437,17362300.0,0.0,0.0,-5.873779296875057,5.873779296875057,0.0,49.4561941269252,286.4860324368262,312.53839297007653,54.25612109112786,-45.74387890887214,0.8494716544983021,0.7413435620510429,0.004237969355029403,623102600.0,-1.0
829,2023-10-04,META,298.41338819255867,306.5747117691397,298.18362099399343,305.256103515625,16880500.0,0.0,0.0,4.635070800781307,0.0,4.635070800781307,56.529992195131854,286.4860324368262,311.6693114353881,74.53386463244385,-25.466135367556152,1.1201723229459049,0.8171093142300154,0.03330733527475127,639983100.0,1.0
830,2023-10-05,META,304.3071458965996,305.88545793630186,299.18257799684585,304.46697998046875,19130000.0,0.0,0.0,-0.78912353515625,0.78912353515625,0.0,55.017401845063034,286.4860324368262,310.3107841636394,75.47171005104812,-24.52828994895189,1.2565442413786627,0.904996299659745,0.01909198757163777,620853100.0,-1.0
831,2023-10-06,META,301.1205101782655,315.9747447847231,300.5910731376499,315.0956726074219,21784000.0,0.0,0.0,10.628692626953125,0.0,10.628692626953125,68.22901476426172,286.4860324368262,315.9747447847231,97.01895366969484,-2.981046330305158,2.1969413581566073,1.1633853113591177,0.04853242293784721,642637100.0,1.0
832,2023-10-09,META,312.16877819444363,319.9904656873814,311.48950624954824,318.0225524902344,22503700.0,0.0,0.0,2.9268798828125,0.0,2.9268798828125,70.9408721066473,286.4860324368262,319.9904656873814,94.1264095338356,-5.8735904661644005,3.1421665714529468,1.5591415633778838,0.06489158218660296,665140800.0,1.0
833,2023-10-10,META,318.7817526196939,324.31588918431044,317.8227786812625,321.4988708496094,19038000.0,0.0,0.0,3.476318359375,0.0,3.476318359375,73.9841193521968,286.4860324368262,324.31588918431044,92.55345228107849,-7.446547718921502,4.124232526256208,2.0721597559535487,0.08094313125083175,684178800.0,1.0
834,2023-10-11,META,322.6676650526188,328.49147266751595,322.60773108291187,327.4725646972656,22036300.0,0.0,0.0,5.97369384765625,0.0,5.97369384765625,78.45738258935279,286.4860324368262,328.49147266751595,97.57434283594083,-2.4256571640591837,5.323191461547253,2.72236609707229,0.0784972949677194,706215100.0,1.0
835,2023-10-12,META,327.6523632152852,330.1896796858055,322.34799355449053,323.8164367675781,20530500.0,0.0,0.0,-3.6561279296875,3.6561279296875,0.0,69.96214778960999,286.4860324368262,330.1896796858055,85.41713719699622,-14.582862803003776,5.910226743668034,3.359938226391439,0.0797775076563152,685684600.0,-1.0
836,2023-10-13,META,323.1871030300875,324.7054810717518,312.03892738340585,314.3564758300781,21341000.0,0.0,0.0,-9.4599609375,9.4599609375,0.0,52.87088898861264,286.4860324368262,330.1896796858055,63.77143590436343,-36.22856409563658,5.548161079700492,3.79758279705325,0.02565023455620108,664343600.0,-1.0
837,2023-10-16,META,318.3022819573982,321.4789040976707,315.1855632979191,320.8096008300781,16536100.0,0.0,0.0,6.453125,0.0,6.453125,60.47152034531147,286.4860324368262,330.1896796858055,78.53707997804129,-21.462920021958702,5.716043578641063,4.181274953370813,0.06715620638022513,680879700.0,1.0
838,2023-10-17,META,317.84274711537483,324.0561556280332,316.9636749679533,323.6565856933594,16387800.0,0.0,0.0,2.84698486328125,0.0,2.84698486328125,63.47045926555366,296.3855331510331,330.1896796858055,80.6736904724812,-19.326309527518802,6.00954520726674,4.546929004149998,0.06027883461073036,697267500.0,1.0
839,2023-10-18,META,321.0493616980794,325.5945267937174,315.2255240551126,316.634033203125,16851000.0,0.0,0.0,-7.022552490234375,7.022552490234375,0.0,52.1990578517877,298.18362099399343,330.1896796858055,57.646623680820866,-42.353376319179134,5.610808267365712,4.7597048567931415,0.0399618153122443,680416500.0,-1.0
840,2023-10-19,META,319.5409685115637,321.54884789577466,311.4195805079297,312.4784545898437,18709200.0,0.0,0.0,-4.155578613281307,4.155578613281307,0.0,46.55424000268111,298.18362099399343,330.1896796858055,44.66289877643455,-55.337101223565455,4.90296760515497,4.788357406465508,-0.008306105875465208,661707300.0,-1.0
841,2023-10-20,META,313.8070471545748,314.9657908048268,306.14516343025235,308.3228454589844,22287400.0,0.0,0.0,-4.155609130859318,4.155609130859318,0.0,41.38971060492693,298.18362099399343,330.1896796858055,31.67907852266984,-68.32092147733016,3.961015784191943,4.622889082010795,-0.030500060311124844,639419900.0,-1.0
842,2023-10-23,META,309.1719555312805,317.0236099467564,306.93433950177257,313.6771850585937,17796800.0,0.0,0.0,5.354339599609318,0.0,5.354339599609318,49.68756774333771,298.18362099399343,330.1896796858055,48.408222373734155,-51.591777626265845,3.6050063031968307,4.419312526248002,-0.024328812634226926,657216700.0,1.0
843,2023-10-24,META,316.44424712641194,318.01259041705475,310.3007715411339,312.2187194824219,19525500.0,0.0,0.0,-1.4584655761718182,1.4584655761718182,0.0,47.570811615821846,299.18257799684585,330.1896796858055,42.04243794323302,-57.957562056766974,3.16865398692687,4.169180818383776,-0.04658052875038643,637691200.0,-1.0
844,2023-10-25,META,309.6714283924023,310.55050055063725,298.5232533120479,299.2125244140625,42192500.0,0.0,0.0,-13.006195068359375,13.006195068359375,0.0,33.073087886952464,298.5232533120479,330.1896796858055,2.176662102250291,-97.82333789774971,1.7531414019120461,3.68597293508943,-0.07598104839617914,595498700.0,-1.0
845,2023-10-26,META,294.6873178642501,294.6873178642501,279.10384682251805,288.0443725585937,66684100.0,0.0,0.0,-11.168151855468807,11.168151855468807,0.0,25.402689619965997,279.10384682251805,330.1896796858055,17.500988503019393,-82.4990114969806,-0.2667638406784931,2.8954255799358455,-0.08370148317131265,528814600.0,-1.0
846,2023-10-27,META,294.1678816771615,298.99274878353526,292.6594724218849,296.4154968261719,29596300.0,0.0,0.0,8.371124267578182,0.0,8.371124267578182,37.865747990868236,279.10384682251805,330.1896796858055,33.88737940317449,-66.1126205968255,-1.1784887189439814,2.0806427201598803,-0.07603919564996742,558410900.0,1.0
847,2023-10-30,META,298.7729795423831,309.0720491447505,298.7330134040307,302.3392028808594,28435100.0,0.0,0.0,5.9237060546875,0.0,5.9237060546875,45.324283481801274,279.10384682251805,330.1896796858055,45.48297395977129,-54.5170260402287,-1.4068267072433969,1.3831488346792247,-0.0658642022279029,586846000.0,1.0
848,2023-10-31,META,302.98853000567215,303.35813297810387,296.5453539387523,300.95068359375,19434200.0,0.0,0.0,-1.388519287109375,1.388519287109375,0.0,43.89905662633675,279.10384682251805,330.1896796858055,42.76496152993534,-57.23503847006466,-1.680456838564055,0.7704277000305686,-0.0495314715563564,567411800.0,-1.0
849,2023-11-01,META,301.53006940939895,312.4085110342077,301.53006940939895,311.5194702148437,20434600.0,0.0,0.0,10.568786621093693,0.0,10.568786621093693,56.03954918933794,279.10384682251805,325.5945267937174,69.72499307905774,-30.27500692094226,-1.0325948997801788,0.40982318006841906,-0.0030689615905159506,587846400.0,1.0
850,2023-11-02,META,316.9636742041399,318.482082631566,308.00318049499805,310.5404968261719,21631800.0,0.0,0.0,-0.9789733886718182,0.9789733886718182,0.0,54.77270274122927,279.10384682251805,325.5945267937174,67.61925190840098,-32.38074809159902,-0.5913380336777436,0.20959093731918652,0.007192627467764279,566214600.0,-1.0
851,2023-11-03,META,312.2187254869568,315.2155458774324,310.6903483072236,314.2665710449219,16754100.0,0.0,0.0,3.72607421875,0.0,3.72607421875,58.8573120980028,279.10384682251805,325.5945267937174,75.63392113040048,-24.36607886959952,0.05835159708078663,0.17934306927150653,0.001878957139385573,582968700.0,1.0
852,2023-11-06,META,315.64510338264824,317.9925882265615,314.11672625094616,315.4652709960937,12887700.0,0.0,0.0,1.1986999511718182,0.0,1.1986999511718182,60.19184366118599,279.10384682251805,325.5945267937174,78.2122872715591,-21.787712728440898,0.6623254949944908,0.2759395544161034,0.010398324351127197,595856400.0,1.0
853,2023-11-07,META,316.7239418714365,320.6597682570866,314.78599566184306,318.4820861816406,14055600.0,0.0,0.0,3.016815185546932,0.0,3.016815185546932,63.61873337698299,279.10384682251805,321.54884789577466,92.77473993028991,-7.225260069710098,1.3686341544049583,0.4944784744138745,0.06440091973192974,609912000.0,1.0
854,2023-11-08,META,317.8028246111236,320.98941554952864,314.5462700625851,319.4410705566406,13609700.0,0.0,0.0,0.958984375,0.0,0.958984375,64.73229932602187,279.10384682251805,320.98941554952864,96.30339269599187,-3.696607304008131,1.982913087136069,0.7921653969583136,0.10899951878650316,623521700.0,1.0
855,2023-11-09,META,319.08145889475844,323.8363930220128,318.46209042761035,320.2102355957031,16103100.0,0.0,0.0,0.7691650390625,0.0,0.7691650390625,65.70379333454211,279.10384682251805,323.8363930220128,91.89369321804745,-8.10630678195255,2.502946345951102,1.1343215867568714,0.0802749485917913,639624800.0,1.0
856,2023-11-10,META,319.60091127176287,328.7512066250268,319.1214090292166,328.4215393066406,19096200.0,0.0,0.0,8.2113037109375,0.0,8.2113037109375,74.39273172991497,279.10384682251805,328.7512066250268,99.33598217569366,-0.6640178243063365,3.5368889459251704,1.6148350585905316,0.08626845667797611,658721000.0,1.0
857,2023-11-13,META,325.85427381777765,331.9777510420436,325.3548037662392,328.8410949707031,16908900.0,0.0,0.0,0.4195556640625,0.0,0.4195556640625,74.76958338928503,279.10384682251805,331.9777510420436,94.06766699444492,-5.9323330055550825,4.340120333246716,2.1598921135217686,0.09267435795095946,675629900.0,1.0
858,2023-11-14,META,334.1854391929692,337.74166361234177,332.9766996878676,335.9535522460937,17179400.0,0.0,0.0,7.112457275390568,0.0,7.112457275390568,80.40907657821677,279.10384682251805,337.74166361234177,96.95058331953724,-3.049416680462755,5.487348096159224,2.82538331004926,0.07843516815946905,692809300.0,1.0
859,2023-11-15,META,337.5718295178242,338.0413325965302,329.6702094616465,332.3573608398437,14531200.0,0.0,0.0,-3.59619140625,3.59619140625,0.0,71.13312301089208,292.6594724218849,338.0413325965302,87.47523408072611,-12.524765919273891,6.036763728267886,3.467659393692986,0.07025448930702272,678278100.0,-1.0
860,2023-11-16,META,329.0208864513309,334.225355687649,326.03406539301056,333.8357849121094,18932600.0,0.0,0.0,1.4784240722656818,0.0,1.4784240722656818,72.63080513498421,296.5453539387523,338.0413325965302,89.86516809470994,-10.134831905290051,6.516359500737735,4.077399415101937,0.06226947333953081,697210700.0,1.0
861,2023-11-17,META,329.90997345644536,335.1444099247344,329.0009342899268,334.6849060058594,14494400.0,0.0,0.0,0.84912109375,0.0,0.84912109375,73.54054909955575,296.5453539387523,338.0413325965302,91.9114413028991,-8.088558697100892,6.885586819829598,4.639036896047469,0.06092472540346194,711705100.0,1.0
862,2023-11-20,META,334.5350776846502,341.50766034227865,333.83580739346155,339.60968017578125,16960500.0,0.0,0.0,4.924774169921875,0.0,4.924774169921875,78.3552955239234,301.53006940939895,341.50766034227865,95.25238984589139,-4.747610154108622,7.489258721630165,5.209081261164009,0.06633840617990328,728665600.0,1.0
863,2023-11-21,META,337.9714085880417,339.5397519448799,335.5439913324418,336.62286376953125,12027900.0,0.0,0.0,-2.98681640625,2.98681640625,0.0,69.50462071103712,308.00318049499805,341.50766034227865,85.42046736730975,-14.57953263269025,7.638608810094695,5.6949867709501465,0.05378705118584337,716637700.0,-1.0
864,2023-11-22,META,338.8504695040606,342.55655929791453,338.2211323509445,341.1280517578125,10702700.0,0.0,0.0,4.50518798828125,0.0,4.50518798828125,74.5147528205083,310.6903483072236,342.55655929791453,95.51717165081428,-4.482828349185729,8.027959519695742,6.161581320699266,0.06532525771137498,727340400.0,1.0
865,2023-11-24,META,339.7695010890384,341.4976479514814,336.4130465007332,337.8715209960937,5467500.0,0.0,0.0,-3.256530761718807,3.256530761718807,0.0,65.53474115247262,314.11672625094616,342.55655929791453,83.52649154415394,-16.473508455846066,7.981739428319656,6.525612942223345,0.02877394006922862,721872900.0,-1.0
866,2023-11-27,META,335.823687770369,339.53974629753907,333.8458058106588,334.34527587890625,15684500.0,0.0,0.0,-3.526245117187443,3.526245117187443,0.0,56.95847571823021,314.5462700625851,342.55655929791453,70.68476033924213,-29.315239660757864,7.573271212159682,6.735144596210613,0.016738117566156063,706188400.0,-1.0
867,2023-11-28,META,333.04663508774007,339.0203080728771,333.04663508774007,338.6307067871094,12637200.0,0.0,0.0,4.285430908203125,0.0,4.285430908203125,63.632268840216476,314.5462700625851,342.55655929791453,85.98424858157668,-14.015751418423317,7.508798899882606,6.889875456945012,0.007968823437397798,718825600.0,1.0
868,2023-11-29,META,339.3299828963619,339.53975179255525,330.4294224779209,331.8479309082031,16024500.0,0.0,0.0,-6.78277587890625,6.78277587890625,0.0,49.589929494870894,318.46209042761035,342.55655929791453,55.55565699599414,-44.44434300400586,6.8316399190571815,6.878228349367447,-0.0015327776413714966,702801100.0,-1.0
869,2023-11-30,META,331.53825005828435,333.1465290137146,322.05828761816053,326.8032531738281,23146400.0,0.0,0.0,-5.044677734375,5.044677734375,0.0,41.693904870724836,319.1214090292166,342.55655929791453,32.779154631118764,-67.22084536888124,5.820824382559351,6.666747556005827,-0.0210658415188556,679654700.0,-1.0
870,2023-12-01,META,325.1350426657253,326.51355442980696,320.4200440591287,324.4757385253906,15264700.0,0.0,0.0,-2.3275146484375,2.3275146484375,0.0,38.43584999470381,320.4200440591287,342.55655929791453,18.32128689865264,-81.67871310134736,4.7768700262184325,6.288772050048348,-0.030503818060710564,664390000.0,-1.0
871,2023-12-04,META,316.9537295444276,320.5199227203203,313.32757191296525,319.6808166503906,19037100.0,0.0,0.0,-4.794921875,4.794921875,0.0,32.414870666004845,313.32757191296525,342.55655929791453,21.736109615267797,-78.2638903847322,3.5220189196849105,5.735421423975661,-0.05868167101442889,645352900.0,-1.0
872,2023-12-05,META,318.64193837508503,321.5388586980682,315.05574691334493,317.9526672363281,16952100.0,0.0,0.0,-1.7281494140625,1.7281494140625,0.0,30.432366829843076,313.32757191296525,342.55655929791453,15.8236591040593,-84.17634089594071,2.3608784273677657,5.060512824654083,-0.05546324549714976,628400800.0,-1.0
873,2023-12-06,META,321.58878817222995,321.9084563297272,316.7039867973911,317.1135559082031,11294300.0,0.0,0.0,-0.839111328125,0.839111328125,0.0,29.424136691979328,313.32757191296525,342.55655929791453,12.95284008773895,-87.04715991226105,1.3573107181995283,4.319872403363172,-0.07039730601416128,617106500.0,-1.0
874,2023-12-07,META,317.43317667090673,327.8920804759891,317.43317667090673,326.24383544921875,15905100.0,0.0,0.0,9.130279541015625,0.0,9.130279541015625,50.156367235591915,313.32757191296525,342.55655929791453,44.189911084310765,-55.810088915689235,1.2839131711100435,3.7126805569125465,-0.03441451801736606,633011600.0,1.0
875,2023-12-08,META,322.74754361352365,332.81687659258336,322.657642665436,332.3973083496094,14077500.0,0.0,0.0,6.153472900390625,0.0,6.153472900390625,59.42529201581146,313.32757191296525,342.55655929791453,65.2425490677915,-34.7574509322085,1.7026518064361085,3.310674806817259,-0.0058262152027606096,647089100.0,1.0
876,2023-12-11,META,329.05087012465805,329.5403715144485,319.6608390739086,324.93524169921875,25802500.0,0.0,0.0,-7.462066650390625,7.462066650390625,0.0,47.155464994588336,313.32757191296525,342.55655929791453,39.712870081262444,-60.287129918737556,1.416055377871544,2.931750921028116,-0.04044365975499298,621286600.0,-1.0
877,2023-12-12,META,324.2559545274346,334.1154881926439,324.2159883885592,333.8657531738281,18485500.0,0.0,0.0,8.930511474609375,0.0,8.930511474609375,58.879783833795486,313.32757191296525,342.55655929791453,70.2664823463521,-29.733517653647883,1.8877820996580112,2.7229571567540956,0.0060805630461597815,639772100.0,1.0
878,2023-12-13,META,333.5760538445142,338.0113502418112,332.2874430897287,334.3851928710937,16353300.0,0.0,0.0,0.5194396972655682,0.0,0.5194396972655682,59.483080148860765,313.32757191296525,341.4976479514814,74.75173630819087,-25.248263691809125,2.2772921607675585,2.6338241575567882,0.02320031891859009,656125400.0,1.0
879,2023-12-14,META,333.49616649912355,334.3452717015821,328.29169698887586,332.81689453125,19607300.0,0.0,0.0,-1.5682983398436932,1.5682983398436932,0.0,56.5906592578508,313.32757191296525,339.53975179255525,74.35216265038692,-25.64783734961309,2.4314053944110015,2.593340404927631,0.025706562973757396,636518100.0,-1.0
880,2023-12-15,META,331.63811528624166,338.30105919170734,330.86894238104355,334.5650329589844,30001600.0,0.0,0.0,1.748138427734375,0.0,1.748138427734375,59.1457167670241,313.32757191296525,339.53975179255525,81.02134634958605,-18.978653650413943,2.6638936942202918,2.607451062786163,0.046559616759461075,666519700.0,1.0
881,2023-12-18,META,337.122313807677,347.19161653900284,336.6627794151925,344.2547302246094,18993900.0,0.0,0.0,9.689697265625,0.0,9.689697265625,70.31895338826092,313.32757191296525,347.19161653900284,91.32742013889465,-8.672579861105344,3.5886521814967978,2.80369128652829,0.08272320284934565,685513600.0,1.0
882,2023-12-19,META,345.2137148842268,353.2252341949607,344.754210962725,349.9886474609375,17729400.0,0.0,0.0,5.733917236328125,0.0,5.733917236328125,74.98936572219682,313.32757191296525,353.2252341949607,91.88777850905872,-8.112221490941273,4.729688240547546,3.1888906773321417,0.10366977677312206,703243000.0,1.0
883,2023-12-20,META,348.28045291081605,354.5837623788944,347.42137907464155,348.9097900390625,16369900.0,0.0,0.0,-1.078857421875,1.078857421875,0.0,72.5122409586033,313.32757191296525,354.5837623788944,86.24697948173944,-13.753020518260561,5.483700079902974,3.647852557846309,0.06947550306547257,686873100.0,-1.0
884,2023-12-21,META,352.6058823002862,356.0322394765689,348.8398586679814,353.7146911621094,15289600.0,0.0,0.0,4.804901123046875,0.0,4.804901123046875,76.50122054754667,313.32757191296525,356.0322394765689,94.5730796030485,-5.426920396951512,6.395254741161921,4.197332994509432,0.06413223656455957,702162700.0,1.0
885,2023-12-22,META,355.2031232828578,356.82143192506845,350.8477588843393,353.0154724121094,11764200.0,0.0,0.0,-0.69921875,0.69921875,0.0,74.68147001857086,315.05574691334493,356.82143192506845,90.88735283070119,-9.112647169298803,6.980777213951399,4.754021838397826,0.08641792920351654,690398500.0,-1.0
886,2023-12-26,META,354.6137525385586,356.6016641583025,353.0754066636714,354.45391845703125,9898600.0,0.0,0.0,1.438446044921875,0.0,1.438446044921875,76.03465035180584,316.7039867973911,356.82143192506845,94.09854376194102,-5.901456238058979,7.474714707333817,5.298160412185024,0.06166599924516314,700297100.0,1.0
887,2023-12-27,META,355.6926003068876,358.6194874141744,354.9333960935778,357.4507141113281,13207900.0,0.0,0.0,2.996795654296875,0.0,2.996795654296875,78.76312132121764,317.43317667090673,358.6194874141744,97.16222870717472,-2.837771292825275,8.0155814587269,5.8416446214933995,0.06897889539363145,713505000.0,1.0
888,2023-12-28,META,359.3187582497265,361.5164081301815,357.4307468694003,357.9402160644531,11798800.0,0.0,0.0,0.489501953125,0.0,0.489501953125,79.20924073509515,319.6608390739086,361.5164081301815,91.45587517656169,-8.544124823438317,8.387040391471771,6.350723775489075,0.07548691771968974,725303800.0,1.0
889,2023-12-29,META,358.60950648730056,359.6184457709883,351.44712284742576,353.5848388671875,14980500.0,0.0,0.0,-4.355377197265625,4.355377197265625,0.0,65.15712811788164,319.6608390739086,361.5164081301815,81.05014591408285,-18.949854085917153,8.235053166077535,6.727589653606767,0.05684935374144384,710323300.0,-1.0
890,2024-01-02,META,350.94764108543427,352.7856871998778,339.6496310628868,345.9229736328125,19042200.0,0.0,0.0,-7.661865234375,7.661865234375,0.0,47.906151180198435,324.2159883885592,361.5164081301815,58.1950160202385,-41.80498397976151,7.410925173439978,6.864256757573409,0.004845956385594707,691281100.0,-1.0
891,2024-01-03,META,344.61435810963064,347.5812113523189,342.81624768317096,344.1048889160156,15451100.0,0.0,0.0,-1.818084716796875,1.818084716796875,0.0,44.66814834745849,328.29169698887586,361.5164081301815,47.594670905898354,-52.40532909410164,6.535753462421724,6.798556098543072,-0.0168112839876573,675830000.0,-1.0
892,2024-01-04,META,344.1348570670982,347.78098225682953,343.0360168836257,346.7520751953125,12099900.0,0.0,0.0,2.647186279296875,0.0,2.647186279296875,50.310601676374574,328.29169698887586,361.5164081301815,55.56219323600475,-44.43780676399525,5.986767653863922,6.636198409607243,-0.00618416251234577,687929900.0,1.0
893,2024-01-05,META,346.6222307863573,353.1253408786045,345.89302399183947,351.5769958496094,13920700.0,0.0,0.0,4.824920654296875,0.0,4.824920654296875,59.08519232698833,330.86894238104355,361.5164081301815,67.56856713070411,-32.431432869295904,5.873319249132692,6.4836225775123335,-0.00604355817248281,701850600.0,1.0
894,2024-01-08,META,354.32408226352777,358.59954487241606,351.6768664863245,358.2798767089844,13890200.0,0.0,0.0,6.702880859375,0.0,6.702880859375,68.11160231379448,336.6627794151925,361.5164081301815,86.97763027559348,-13.02236972440651,6.252205503357061,6.43733916268128,0.014912672979753516,715740800.0,1.0
895,2024-01-09,META,356.02224039223245,360.25776708491344,354.98333416739763,357.0511474609375,13463900.0,0.0,0.0,-1.228729248046875,1.228729248046875,0.0,65.07497726977039,339.6496310628868,361.5164081301815,79.57970369614954,-20.420296303850456,6.3797852156865815,6.425828373282341,0.007327409484460423,702276900.0,-1.0
896,2024-01-10,META,359.7882609440346,372.5447147525505,358.6993894331084,370.0773315429688,22117200.0,0.0,0.0,13.026184082031307,0.0,13.026184082031307,77.39999457239158,339.6496310628868,372.5447147525505,92.4992341321905,-7.500765867809515,7.44616251894297,6.629895202414468,0.035324079469339464,724394100.0,1.0
897,2024-01-11,META,371.7355823394237,372.3848873039691,362.54532127356975,369.2781982421875,17205400.0,0.0,0.0,-0.7991333007813068,0.7991333007813068,0.0,75.51362796340707,339.6496310628868,372.5447147525505,90.06989451317499,-9.930105486825019,8.133038233837908,6.930523808699157,0.031675630926290665,707188700.0,-1.0
898,2024-01-12,META,369.7676812744652,376.66036205755694,369.1483432730176,374.0930786132813,19295700.0,0.0,0.0,4.814880371093807,0.0,4.814880371093807,79.06133911251602,339.6496310628868,376.66036205755694,93.06340789473913,-6.936592105260879,8.962597546543122,7.336938556267951,0.058000902447621794,726484400.0,1.0
899,2024-01-16,META,373.25396787373256,375.21188196327273,366.8407894071454,367.0705261230469,15306900.0,0.0,0.0,-7.022552490234432,7.022552490234432,0.0,63.56298749459234,339.6496310628868,376.66036205755694,74.08903937646875,-25.91096062353126,8.950195698785649,7.6595899847714914,0.061133703460475974,711177500.0,-1.0
900,2024-01-17,META,365.9117399359326,368.14938645014166,358.2298882645727,367.97955322265625,12724800.0,0.0,0.0,0.909027099609375,0.0,0.909027099609375,64.59946739120784,339.6496310628868,376.66036205755694,76.54515703526418,-23.454842964735807,8.910997601366205,7.909871508090435,0.06938193869273279,723902300.0,1.0
901,2024-01-18,META,371.0962569509754,376.45059186853535,370.5568512333231,375.7313537597656,16354300.0,0.0,0.0,7.751800537109375,0.0,7.751800537109375,72.34101829739589,339.6496310628868,376.66036205755694,97.48989476072467,-2.5101052392753274,9.397114260857336,8.207320058643816,0.08357348271998144,740256600.0,1.0
902,2024-01-19,META,378.5983137934355,383.9526183212959,377.5694066666516,383.0436096191406,21470100.0,0.0,0.0,7.312255859375,0.0,7.312255859375,77.65870965592298,339.6496310628868,383.9526183212959,97.94819997835981,-2.0518000216401924,10.254199127123059,8.616695872339665,0.08950134434561074,761726700.0,1.0
903,2024-01-22,META,387.5388403008646,389.9362905447284,380.7560282005064,381.3753662109375,17680500.0,0.0,0.0,-1.668243408203125,1.668243408203125,0.0,73.91767949414823,339.6496310628868,389.9362905447284,82.97575455994995,-17.024245440050052,10.675768148024474,9.028510327476628,0.06446214538784334,744046200.0,-1.0
904,2024-01-23,META,384.2123457030919,387.9683703254653,381.6750292516864,384.791748046875,15506100.0,0.0,0.0,3.4163818359375,0.0,3.4163818359375,76.58320799934265,342.81624768317096,389.9362905447284,89.0820504706065,-10.917949529393486,11.156927975453812,9.454193857072065,0.07769363236389659,759552300.0,1.0
905,2024-01-24,META,389.586648907577,395.7301245817652,387.39896759412346,390.2859191894531,15698500.0,0.0,0.0,5.494171142578125,0.0,5.494171142578125,80.3160025692004,343.0360168836257,395.7301245817652,89.66828431083898,-10.331715689161017,11.845042027986494,9.932363491254952,0.054606391486418104,775250800.0,1.0
906,2024-01-25,META,389.7564860686874,395.07082442059465,385.25125630245617,392.7632751464844,15091100.0,0.0,0.0,2.47735595703125,0.0,2.47735595703125,81.82348239355862,345.89302399183947,395.7301245817652,94.04690601948748,-5.953093980512513,12.446800327255573,10.435250858455078,0.06359724732217864,790341900.0,1.0
907,2024-01-26,META,393.9320284033557,396.3694446482537,391.1749440149753,393.7222595214844,13163700.0,0.0,0.0,0.958984375,0.0,0.958984375,82.42467361866028,351.6768664863245,396.3694446482537,94.07690217114326,-5.92309782885674,12.852919681819515,10.918784623127966,0.052471382205108164,803505600.0,1.0
908,2024-01-29,META,394.5713327183665,402.5029193979018,392.683351818174,400.5949401855469,18742400.0,0.0,0.0,6.8726806640625,0.0,6.8726806640625,86.19924292240852,354.98333416739763,402.5029193979018,95.98485718446437,-4.0151428155356275,13.572880371790404,11.449603772860454,0.09132962653411769,822248000.0,1.0
909,2024-01-30,META,403.1622437707846,405.9292969586873,399.1465154192598,399.635986328125,18614700.0,0.0,0.0,-0.958953857421875,0.958953857421875,0.0,83.3183692276638,358.2298882645727,405.9292969586873,86.80631311193004,-13.193686888069966,13.905777694470032,11.94083855718237,0.08602769590927273,803633300.0,-1.0
910,2024-01-31,META,388.5876951289836,397.5781559417365,386.68971505444887,389.72650146484375,20180800.0,0.0,0.0,-9.90948486328125,9.90948486328125,0.0,59.57719897409015,358.2298882645727,405.9292969586873,66.03145418898507,-33.96854581101493,13.217624067701763,12.19619565928625,0.037247750460629225,783452500.0,-1.0
911,2024-02-01,META,393.5224662381357,400.0755108687275,392.6333949144047,394.361572265625,29727100.0,0.0,0.0,4.63507080078125,0.0,4.63507080078125,64.96505521518884,358.2298882645727,405.9292969586873,75.74870420880167,-24.25129579119833,12.897593408691705,12.336475209167343,0.029547451940884262,813179600.0,1.0
912,2024-02-02,META,459.1128696750721,485.4449157121275,452.52985816580826,474.4865417480469,84615500.0,0.0,0.0,80.12496948242188,0.0,80.12496948242188,90.42388375673178,358.2298882645727,485.4449157121275,91.38594379614602,-8.614056203853979,18.891611468739825,13.647502461081842,0.2441457518931882,897795100.0,1.0
913,2024-02-05,META,469.3819690283014,471.3998170124677,458.733264131787,458.9230651855469,40832400.0,0.0,0.0,-15.5634765625,15.5634765625,0.0,77.75967498942268,358.2298882645727,485.4449157121275,79.1519515746562,-20.848048425343805,22.130959551781416,15.344193879221757,0.19265308446698093,856962700.0,-1.0
914,2024-02-06,META,463.5081998877201,466.6248880782935,452.51985894210605,454.238037109375,21655200.0,0.0,0.0,-4.685028076171875,4.685028076171875,0.0,74.15244471480585,370.5568512333231,485.4449157121275,72.83714479452317,-27.16285520547683,24.042971228588556,17.083949349095118,0.16385965974057637,835307500.0,-1.0
915,2024-02-07,META,457.5145728764048,471.0202322626139,455.6964945498286,469.09228515625,23066000.0,0.0,0.0,14.854248046875,0.0,14.854248046875,77.90258329572973,377.5694066666516,485.4449157121275,84.84120195531692,-15.158798044683072,26.45194636043351,18.957548751362797,0.19433845993187138,858373500.0,1.0
916,2024-02-08,META,467.8236494686336,470.0912325913305,464.5371279017624,469.5018615722656,18815100.0,0.0,0.0,0.409576416015625,0.0,0.409576416015625,78.00411494984267,380.7560282005064,485.4449157121275,84.7710157985086,-15.228984201491405,28.07054611953589,20.78014822499742,0.1924696920689244,877188600.0,1.0
917,2024-02-09,META,472.4487274255926,473.0880332304199,466.974524761579,467.6138305664063,18413100.0,0.0,0.0,-1.8880310058593182,1.8880310058593182,0.0,76.14325586620254,381.6750292516864,485.4449157121275,82.8167055453812,-17.1832944546188,28.86817541048913,22.397753662095763,0.1672983946073252,858775500.0,-1.0
918,2024-02-12,META,467.6937761889501,478.6421513441107,466.08546674697993,468.4030151367188,19382000.0,0.0,0.0,0.7891845703125,0.0,0.7891845703125,76.41462233180927,385.25125630245617,485.4449157121275,82.99103887829082,-17.008961121709174,29.227071482624922,23.763617226201596,0.17207416539343368,878157500.0,1.0
919,2024-02-13,META,456.3857688211075,467.3941084799706,454.6076566227311,459.63232421875,20916600.0,0.0,0.0,-8.770690917968807,8.770690917968807,0.0,66.68733986854608,385.25125630245617,485.4449157121275,74.23730039858599,-25.762699601414013,28.475529568936338,24.70599969474855,0.17937148870080688,857240900.0,-1.0
920,2024-02-14,META,467.4340455795189,473.6074882382667,465.5959994069418,472.77838134765625,16858400.0,0.0,0.0,13.14605712890625,0.0,13.14605712890625,72.69796554207707,386.68971505444887,485.4449157121275,87.17380524760608,-12.826194752393915,28.610895537382817,25.486978863275407,0.19884495497754284,874099300.0,1.0
921,2024-02-15,META,474.7762420360092,488.1020991020434,471.71948781693857,483.5169677734375,24212300.0,0.0,0.0,10.73858642578125,0.0,10.73858642578125,76.66618456475778,386.68971505444887,488.1020991020434,95.47872641821141,-4.521273581788595,29.2475407766525,26.239091245950828,0.019031996128113127,898311600.0,1.0
922,2024-02-16,META,477.60322992035344,478.4523350905636,468.7126692513334,472.8183288574219,23306500.0,0.0,0.0,-10.698638916015625,10.698638916015625,0.0,65.69048062590595,386.68971505444887,488.1020991020434,84.92908889958787,-15.070911100412134,28.559578919484125,26.703188780657488,0.030277980615894817,875005100.0,-1.0
923,2024-02-20,META,469.2221527827373,475.6752974000253,466.06549835609394,471.25,18015500.0,0.0,0.0,-1.568328857421875,1.568328857421875,0.0,64.13739164778394,386.68971505444887,488.1020991020434,83.38260237119127,-16.61739762880874,27.570003322906473,26.876551689107284,0.037451647596233206,856989600.0,-1.0
924,2024-02-21,META,466.5,469.0,461.7900085449219,468.0299987792969,12977100.0,0.5,0.0,-3.220001220703125,3.220001220703125,0.0,60.735627270977965,392.6333949144047,488.1020991020434,78.97520397543487,-21.02479602456513,26.223640540828967,26.745969459451622,-0.002264557338859885,844012500.0,-1.0
925,2024-02-22,META,480.239990234375,489.989990234375,476.05999755859375,486.1300048828125,21625800.0,0.0,0.0,18.100006103515625,0.0,18.100006103515625,70.78552449405444,452.51985894210605,489.989990234375,89.69850059650334,-10.301499403496658,26.313828129235844,26.65954119340847,0.035416565239725806,865638300.0,1.0
926,2024-02-23,META,488.0499877929688,494.3599853515625,482.3500061035156,484.0299987792969,18374300.0,0.0,0.0,-2.100006103515625,2.100006103515625,0.0,68.44040346975919,452.51985894210605,494.3599853515625,75.31081414244746,-24.689185857552538,25.917093381105644,26.511051630947904,0.035106250371179426,847264000.0,-1.0
927,2024-02-26,META,483.4700012207031,486.1400146484375,480.6000061035156,481.739990234375,12101400.0,0.0,0.0,-2.290008544921875,2.290008544921875,0.0,65.70159797240268,452.51985894210605,494.3599853515625,69.83757889810006,-30.162421101899938,25.128231077665816,26.23448752029149,0.02847329045002711,835162600.0,-1.0
928,2024-02-27,META,479.9800109863281,487.2699890136719,479.9200134277344,487.0499877929688,10809600.0,0.0,0.0,5.309997558593807,0.0,5.309997558593807,69.01866248526959,454.6076566227311,494.3599853515625,81.61114633444876,-18.388853665551245,24.647404507440797,25.917070917721354,0.05965129545843273,845972200.0,1.0
929,2024-02-28,META,485.0,491.0499877929688,482.75,484.0199890136719,12715500.0,0.0,0.0,-3.029998779296932,3.029998779296932,0.0,64.8869201395151,454.6076566227311,494.3599853515625,73.98895443729998,-26.01104556270002,23.74809712667536,25.483276159512158,0.02377775319161457,833256700.0,-1.0
930,2024-02-29,META,488.4400024414063,491.7000122070313,482.6099853515625,490.1300048828125,17732000.0,0.0,0.0,6.110015869140625,0.0,6.110015869140625,69.17981042756827,454.6076566227311,494.3599853515625,89.3591630880178,-10.640836911982209,23.260286659686074,25.038678259546945,0.013676949414676454,850988700.0,1.0
931,2024-03-01,META,492.1099853515625,504.25,491.8500061035156,502.2999877929688,16273600.0,0.0,0.0,12.169982910156307,0.0,12.169982910156307,75.94015979986439,454.6076566227311,504.25,96.07187720327461,-3.9281227967253836,23.58384932739665,24.747712473116888,0.06235303738497233,867262300.0,1.0
932,2024-03-04,META,503.0,504.4200134277344,496.4200134277344,498.1900024414063,12324100.0,0.0,0.0,-4.1099853515625,4.1099853515625,0.0,69.96039248989037,454.6076566227311,504.4200134277344,87.49304111283827,-12.506958887161732,23.240728947002935,24.4463157678941,0.05716711393401863,854938200.0,-1.0
933,2024-03-05,META,495.0,495.5799865722656,487.8900146484375,490.2200012207031,15325300.0,0.0,0.0,-7.970001220703182,7.970001220703182,0.0,59.48057012674791,461.7900085449219,504.4200134277344,66.69009950604911,-33.30990049395089,22.071267253136796,23.97130606494264,0.04741149605641004,839612900.0,-1.0
934,2024-03-06,META,497.6300048828125,502.9700012207031,494.2900085449219,496.0899963378906,11757900.0,0.0,0.0,5.8699951171875,0.0,5.8699951171875,64.0562191139272,461.7900085449219,504.4200134277344,80.45973226429952,-19.54026773570048,21.371759641835183,23.451396780321154,0.020488328955294843,851370800.0,1.0
935,2024-03-07,META,503.2799987792969,519.8499755859375,501.3800048828125,512.1900024414062,18586400.0,0.0,0.0,16.100006103515625,0.0,16.100006103515625,73.51966105543798,461.7900085449219,519.8499755859375,86.80679040151715,-13.193209598482847,21.864490522656524,23.134015528788233,0.05817821980688742,869957200.0,1.0
936,2024-03-08,META,514.1900024414062,523.5700073242188,499.3500061035156,505.9500122070313,18575200.0,0.0,0.0,-6.239990234374943,6.239990234374943,0.0,65.77516622325469,461.7900085449219,523.5700073242188,71.47945052551201,-28.520549474487993,21.503588253682665,22.80793007376712,0.0502553710786553,851382000.0,-1.0
937,2024-03-11,META,497.010009765625,497.3200073242188,476.0,483.5899963378906,20428300.0,0.0,0.0,-22.360015869140682,22.360015869140682,0.0,45.81918577900624,461.7900085449219,523.5700073242188,35.28648142394291,-64.71351857605708,19.19206995950583,22.084758050914864,-0.007103976063641548,830953700.0,-1.0
938,2024-03-12,META,493.260009765625,502.30999755859375,484.7300109863281,499.75,15448200.0,0.0,0.0,16.160003662109375,0.0,16.160003662109375,56.759284502937554,476.0,523.5700073242188,49.926416529913894,-50.073583470086106,18.451455406113837,21.35809752195466,0.032498680516031,846401900.0,1.0
939,2024-03-13,META,495.3900146484375,500.9800109863281,491.0299987792969,495.5700073242188,12090700.0,0.0,0.0,-4.179992675781193,4.179992675781193,0.0,53.53316390339348,476.0,523.5700073242188,41.139382617364795,-58.860617382635205,17.327482133407955,20.55197444424532,0.011099101028730018,834311200.0,-1.0
940,2024-03-14,META,500.260009765625,501.3500061035156,488.1600036621094,491.8299865722656,12620000.0,0.0,0.0,-3.740020751953182,3.740020751953182,0.0,50.565953874975904,476.0,523.5700073242188,33.277242242942215,-66.72275775705779,15.951062875360776,19.631792130468412,-0.020844119998303823,821691200.0,-1.0
941,2024-03-15,META,489.010009765625,491.8299865722656,481.2999877929688,484.1000061035156,29141700.0,0.0,0.0,-7.72998046875,7.72998046875,0.0,44.66232563503161,476.0,523.5700073242188,17.027548573430145,-82.97245142656986,14.074256605920198,18.52028502555877,-0.028282374734221682,792549500.0,-1.0
942,2024-03-18,META,491.9100036621094,497.4200134277344,486.80999755859375,496.9800109863281,11755300.0,0.0,0.0,12.8800048828125,0.0,12.8800048828125,54.806606942132,476.0,523.5700073242188,44.10344283391947,-55.89655716608052,13.470898731771399,17.510407766801297,0.013789746947884263,804304800.0,1.0
943,2024-03-19,META,488.1700134277344,496.6300048828125,481.2799987792969,496.239990234375,10903100.0,0.0,0.0,-0.740020751953125,0.740020751953125,0.0,54.148550726619916,476.0,523.5700073242188,42.547797179065086,-57.452202820934914,12.785634938689327,16.565453201178904,0.00030235218930352303,793401700.0,-1.0
944,2024-03-20,META,499.5,508.2000122070313,495.1700134277344,505.5199890136719,11711100.0,0.0,0.0,9.279998779296875,0.0,9.279998779296875,60.93536251295808,476.0,523.5700073242188,62.05588494547638,-37.94411505452362,12.843326912912175,15.821027943525559,-0.013022537331734418,805112800.0,1.0
945,2024-03-21,META,514.7100219726562,515.0399780273438,506.010009765625,507.760009765625,9712500.0,0.0,0.0,2.240020751953125,0.0,2.240020751953125,62.48205443152493,476.0,523.5700073242188,66.76477796011481,-33.235222039885194,12.920855591859208,15.24099347319229,0.003577423687961101,814825300.0,1.0
946,2024-03-22,META,507.0,509.9700012207031,504.3399963378906,509.5799865722656,8117000.0,0.0,0.0,1.819976806640625,0.0,1.819976806640625,63.82479686828333,476.0,523.5700073242188,70.59066933371996,-29.409330666280038,12.979534551762015,14.788701688906235,0.05374385415577421,822942300.0,1.0
947,2024-03-25,META,505.7900085449219,507.2200012207031,500.239990234375,503.0199890136719,8380600.0,0.0,0.0,-6.55999755859375,6.55999755859375,0.0,55.555535235122804,476.0,523.5700073242188,56.80047267916966,-43.19952732083034,12.354288523653338,14.301819055855656,0.006543249652169791,814561700.0,-1.0
948,2024-03-26,META,505.1300048828125,510.0,495.2099914550781,495.8900146484375,11205400.0,0.0,0.0,-7.129974365234375,7.129974365234375,0.0,47.79038260583672,476.0,523.5700073242188,41.81209078416755,-58.18790921583245,11.154860905298335,13.672427425744194,0.0006457358586864359,803356300.0,-1.0
949,2024-03-27,META,499.2999877929688,499.8900146484375,488.0700073242188,493.8599853515625,9989700.0,0.0,0.0,-2.030029296875,2.030029296875,0.0,45.692275331699335,476.0,523.5700073242188,37.544634437064,-62.455365562936,9.926077831283692,12.923157506852094,0.0041274400396864586,793366600.0,-1.0
950,2024-03-28,META,492.8399963378906,492.8900146484375,485.1499938964844,485.5799865722656,15212800.0,0.0,0.0,-8.279998779296875,8.279998779296875,0.0,37.868129902650715,476.0,515.0399780273438,24.538913842512326,-75.46108615748767,8.189725630454973,11.976471131572671,0.0030571791986995223,778153800.0,-1.0
951,2024-04-01,META,487.2000122070313,497.4299926757813,481.7799987792969,491.3500061035156,9247000.0,0.0,0.0,5.77001953125,0.0,5.77001953125,45.38749456757858,481.2799987792969,515.0399780273438,29.82823908223028,-70.17176091776972,7.1962919812233395,11.020435301502806,-0.011328433253560699,787400800.0,1.0
952,2024-04-02,META,485.1000061035156,497.5299987792969,484.6499938964844,497.3699951171875,11081000.0,0.0,0.0,6.019989013671875,0.0,6.019989013671875,52.332260337620724,481.2799987792969,515.0399780273438,47.659971055288736,-52.34002894471126,6.81617879294356,10.179583999790957,0.0022771338567026955,798481800.0,1.0
953,2024-04-03,META,498.9299926757813,507.239990234375,498.75,506.739990234375,12099200.0,0.0,0.0,9.3699951171875,0.0,9.3699951171875,61.194614083782994,481.2799987792969,515.0399780273438,75.41471298905216,-24.585287010947827,7.188156061674761,9.581298412167719,0.0024133590109531866,810581000.0,1.0
954,2024-04-04,META,516.4199829101562,530.0,510.5799865722656,510.9200134277344,26476300.0,0.0,0.0,4.180023193359375,0.0,4.180023193359375,64.5839305154712,481.2799987792969,530.0,60.83746696591265,-39.16253303408735,7.73112407895411,9.211263545524998,0.006223419728481616,837057300.0,1.0
955,2024-04-05,META,516.8599853515625,530.7000122070312,514.4099731445312,527.3400268554688,19242000.0,0.0,0.0,16.420013427734375,0.0,16.420013427734375,74.62812969287798,481.2799987792969,530.7000122070312,93.20116463247076,-6.798835367529231,9.378281014568586,9.244667039333716,0.03485231121941745,856299300.0,1.0
956,2024-04-08,META,529.280029296875,531.489990234375,518.8900146484375,519.25,13260600.0,0.0,0.0,-8.09002685546875,8.09002685546875,0.0,64.2665842672332,481.2799987792969,531.489990234375,75.62240127978139,-24.377598720218614,9.916555320231453,9.379044695513263,0.03226514122858637,843038700.0,-1.0
957,2024-04-09,META,522.22998046875,525.8699951171875,506.739990234375,516.9000244140625,10881400.0,0.0,0.0,-2.3499755859375,2.3499755859375,0.0,61.408897826057924,481.7799987792969,531.489990234375,70.64983237123035,-29.350167628769654,10.03780858624674,9.51079747365996,0.04236828559760397,832157300.0,-1.0
958,2024-04-10,META,509.2900085449219,522.5599975585938,505.7999877929688,519.8300170898438,11418500.0,0.0,0.0,2.92999267578125,0.0,2.92999267578125,63.72916502579933,481.7799987792969,531.489990234375,76.54400493094407,-23.45599506905593,10.252148212256088,9.659067621379187,0.05258581887292224,843575800.0,1.0
959,2024-04-11,META,521.1099853515625,523.8599853515625,517.2899780273438,523.1599731445312,10325700.0,0.0,0.0,3.3299560546875,0.0,3.3299560546875,66.3799191516055,481.7799987792969,531.489990234375,83.24277102849351,-16.757228971506485,10.568882040839924,9.841030505271334,0.07739195933000587,853901500.0,1.0
