,datetime,symbol,Open,High,Low,Close,Volume,Dividends,Stock Splits,change_in_price,down_days,up_days,RSI,low_14,high_14,k_percent,r_percent,MACD,MACD_EMA,Price_Rate_Of_Change,On Balance Volume,Prediction
256,1.0,1.0,1.0,1.0,1.0,1.0,1.0,1.0,1.0,1.0,1.0,1.0,1.0,1.0,1.0,1.0,1.0,1.0,1.0,1.0,1.0,1.0
264,2022-01-21,AMD,120.13999938964844,125.0199966430664,118.38999938964844,118.80999755859376,95685300.0,0.0,0.0,-3.0800018310546733,3.0800018310546733,0.0,17.357831973144926,118.38999938964844,152.4199981689453,1.2341997767006816,-98.76580022329932,-2.1978004701927887,-1.1767976692337894,-0.09992426091974416,-311159900.0,-1.0
265,2022-01-24,AMD,115.4000015258789,116.7699966430664,107.5,116.52999877929688,116210100.0,0.0,0.0,-2.279998779296889,2.279998779296889,0.0,15.716539285528128,107.5,152.4199981689453,20.102402376186234,-79.89759762381377,-2.7490425194644956,-1.5027137934646182,-0.1171969789447207,-427370000.0,-1.0
266,2022-01-25,AMD,114.0999984741211,114.81999969482422,109.86000061035156,111.12999725341795,85102900.0,0.0,0.0,-5.4000015258789205,5.4000015258789205,0.0,12.489272484892396,107.5,143.75999450683594,10.011025381522346,-89.98897461847766,-3.4602774187753766,-1.9055657942815483,-0.1906634678513056,-512472900.0,-1.0
267,2022-01-26,AMD,114.5500030517578,117.16000366210938,108.62999725341795,110.70999908447266,94752600.0,0.0,0.0,-0.4199981689452983,0.4199981689452983,0.0,12.26328407937865,107.5,141.25,9.5111083984375,-90.4888916015625,-3.985742813049967,-2.3311852972091645,-0.19466066704450125,-607225500.0,-1.0
268,2022-01-27,AMD,111.95999908447266,112.75,101.94000244140624,102.5999984741211,125954100.0,0.0,0.0,-8.110000610351562,8.110000610351562,0.0,8.739802344264248,101.94000244140624,141.25,1.6789521081274472,-98.32104789187255,-4.850568935471458,-2.8443055780846107,-0.2270604623456577,-733179600.0,-1.0
269,2022-01-28,AMD,101.5500030517578,105.4000015258789,99.3499984741211,105.23999786376952,98749500.0,0.0,0.0,2.6399993896484233,0.0,2.6399993896484233,17.629145162574787,99.3499984741211,141.25,14.057277267664425,-85.94272273233557,-5.286844697668144,-3.3399564843590888,-0.231151416498933,-634430100.0,1.0
270,2022-01-31,AMD,107.93000030517578,114.30999755859376,106.9000015258789,114.25,97206000.0,0.0,0.0,9.010002136230483,0.0,9.010002136230483,40.46546778328005,99.3499984741211,141.25,35.560861535234416,-64.43913846476558,-4.97199417412682,-3.6701711380665913,-0.1340104120162421,-537224100.0,1.0
271,2022-02-01,AMD,116.75,117.26000213623048,112.7300033569336,116.77999877929688,122467900.0,0.0,0.0,2.529998779296875,0.0,2.529998779296875,45.37237909087846,99.3499984741211,141.25,41.599044559486245,-58.400955440513755,-4.501757709718987,-3.8380367392893384,-0.08957671404421186,-414756200.0,1.0
272,2022-02-02,AMD,129.88999938964844,130.05999755859375,120.63999938964844,122.76000213623048,180065000.0,0.0,0.0,5.980003356933608,0.0,5.980003356933608,55.398213738359566,99.3499984741211,141.25,55.871128423827265,-44.12887157617273,-3.6829391420316426,-3.806786634765629,0.007137605635724853,-234691200.0,1.0
273,2022-02-03,AMD,120.31999969482422,125.37000274658205,118.81999969482422,120.08000183105467,103599500.0,0.0,0.0,-2.6800003051758097,2.6800003051758097,0.0,50.596360812011326,99.3499984741211,137.0,55.05976764087171,-44.94023235912829,-3.1863185860382828,-3.681956155933564,0.010689372094587979,-338290700.0,-1.0
274,2022-02-04,AMD,120.33999633789062,124.95999908447266,118.58000183105467,123.5999984741211,86212000.0,0.0,0.0,3.5199966430664205,0.0,3.5199966430664205,56.33258234101444,99.3499984741211,136.38999938964844,65.46976080077333,-34.53023919922668,-2.5210067012060478,-3.4486645766533317,0.060671069843693415,-252078700.0,1.0
275,2022-02-07,AMD,123.55999755859376,127.62999725341795,122.79000091552734,123.66999816894533,81672500.0,0.0,0.0,0.06999969482423296,0.0,0.06999969482423296,56.448612469722384,99.3499984741211,134.57000732421875,69.0516569667381,-30.9483430332619,-1.9691282049641927,-3.1516351568944674,0.11284082808831064,-170406200.0,1.0
276,2022-02-08,AMD,122.37999725341795,128.7100067138672,122.0500030517578,128.22999572753906,84902800.0,0.0,0.0,4.559997558593736,0.0,4.559997558593736,63.698819145681114,99.3499984741211,130.05999755859375,94.04102284073346,-5.958977159266535,-1.1962549537243206,-2.75937357838468,0.15825125813340946,-85503400.0,1.0
277,2022-02-09,AMD,129.60000610351562,132.9600067138672,127.6500015258789,132.85000610351562,92948900.0,0.0,0.0,4.6200103759765625,0.0,4.6200103759765625,69.61263367266938,99.3499984741211,132.9600067138672,99.67271471769091,-0.32728528230909326,-0.2526232688353076,-2.2568083884063967,0.2948343867375838,7445500.0,1.0
278,2022-02-10,AMD,128.83999633789062,131.75999450683594,124.61000061035156,125.7699966430664,108939900.0,0.0,0.0,-7.080009460449219,7.080009460449219,0.0,54.0444807319935,99.3499984741211,132.9600067138672,78.60753255544249,-21.392467444557514,-0.02015443094596492,-1.8086106564175197,0.19507790950235915,-101494400.0,-1.0
279,2022-02-11,AMD,126.13999938964844,127.16999816894533,111.80999755859376,113.18000030517578,164723200.0,0.0,0.0,-12.589996337890625,12.589996337890625,0.0,37.04546575729345,99.3499984741211,132.9600067138672,41.14846307802978,-58.85153692197023,-0.7461097935170926,-1.5957811461220142,-0.009365424024719626,-266217600.0,-1.0
280,2022-02-14,AMD,115.51000213623048,118.37000274658205,113.45999908447266,114.2699966430664,135146400.0,0.0,0.0,1.089996337890625,0.0,1.089996337890625,38.96329882809666,99.3499984741211,132.9600067138672,44.39153380302184,-55.608466196978156,-1.2250095426585546,-1.5215349130446296,-0.02149342492265427,-131071200.0,1.0
281,2022-02-15,AMD,117.19000244140624,121.87999725341795,114.36000061035156,121.47000122070312,143975900.0,0.0,0.0,7.200004577636719,0.0,7.200004577636719,50.46477466630902,99.3499984741211,132.9600067138672,65.81373794613845,-34.18626205386156,-1.0582628424814118,-1.4287886474794762,-0.01050831617040704,12904700.0,1.0
282,2022-02-16,AMD,119.0500030517578,119.54000091552734,114.22000122070312,117.69000244140624,119109600.0,0.0,0.0,-3.779998779296889,3.779998779296889,0.0,45.294487536002265,99.3499984741211,132.9600067138672,54.56709155339288,-45.432908446607115,-1.1939809411979354,-1.3817898699553315,-0.019903392348469717,-106204900.0,-1.0
283,2022-02-17,AMD,116.26000213623048,116.9800033569336,112.26000213623048,112.37000274658205,98179600.0,0.0,0.0,-5.31999969482419,5.31999969482419,0.0,38.83347691814077,106.9000015258789,132.9600067138672,20.990023529329157,-79.00997647067084,-1.6802196676728016,-1.441513683963163,-0.09085757173282116,-204384500.0,-1.0
284,2022-02-18,AMD,113.9000015258789,115.63999938964844,109.88999938964844,113.83000183105467,114321200.0,0.0,0.0,1.4599990844726278,0.0,1.4599990844726278,41.476926976437724,109.88999938964844,132.9600067138672,17.07846203095933,-82.92153796904067,-1.9322833142591662,-1.5397174052248446,-0.07956656006777207,-90063300.0,1.0
285,2022-02-22,AMD,115.2699966430664,119.1999969482422,113.61000061035156,115.6500015258789,141648500.0,0.0,0.0,1.819999694824233,0.0,1.819999694824233,44.90192540527129,109.88999938964844,132.9600067138672,24.967491580220067,-75.03250841977993,-1.9709220631205397,-1.6259933344787045,-0.09810492568673179,51585200.0,1.0
286,2022-02-23,AMD,117.4000015258789,118.6500015258789,109.04000091552734,109.76000213623048,120299400.0,0.0,0.0,-5.889999389648423,5.889999389648423,0.0,36.84904373916297,109.04000091552734,132.9600067138672,3.010037818440289,-96.9899621815597,-2.421382577380541,-1.7851228235307035,-0.17380506515967786,-68714200.0,-1.0
287,2022-02-24,AMD,104.55999755859376,116.95999908447266,104.26000213623048,116.61000061035156,142956600.0,0.0,0.0,6.8499984741210795,0.0,6.8499984741210795,49.09902868143161,104.26000213623048,132.9600067138672,43.03134670488626,-56.96865329511374,-2.228564833065704,-1.873834256242373,-0.07283132922958402,74242400.0,1.0
288,2022-02-25,AMD,117.16000366210938,121.2300033569336,116.04000091552734,121.05999755859376,127821000.0,0.0,0.0,4.449996948242202,0.0,4.449996948242202,55.560636543803675,104.26000213623048,132.9600067138672,58.536560079345726,-41.46343992065428,-1.714584817100345,-1.8419777520769076,0.06962358395626933,202063400.0,1.0
289,2022-02-28,AMD,120.30999755859376,124.61000061035156,119.1999969482422,123.33999633789062,124666100.0,0.0,0.0,2.279998779296861,0.0,2.279998779296861,58.66289112963695,104.26000213623048,132.9600067138672,66.48080543000137,-33.51919456999864,-1.1190785037883018,-1.6973738759791355,0.07937341350551752,326729500.0,1.0
290,2022-03-01,AMD,122.33000183105467,122.43000030517578,112.8000030517578,113.83000183105467,126552200.0,0.0,0.0,-9.509994506835952,9.509994506835952,0.0,43.910267905218134,104.26000213623048,132.9600067138672,33.34494135335859,-66.65505864664141,-1.3666011940890286,-1.631210544985929,-0.06289618270248531,200177300.0,-1.0
291,2022-03-02,AMD,115.47000122070312,119.4800033569336,113.30999755859376,118.27999877929688,118354500.0,0.0,0.0,4.449996948242202,0.0,4.449996948242202,50.6156357717047,104.26000213623048,131.75999450683594,50.98182011880217,-49.01817988119784,-1.203645290187552,-1.5456883997518773,0.005013138972313147,318531800.0,1.0
292,2022-03-03,AMD,118.12999725341795,118.26000213623048,111.0500030517578,111.9800033569336,123916700.0,0.0,0.0,-6.299995422363281,6.299995422363281,0.0,42.346100648332005,104.26000213623048,127.16999816894533,33.69708667639733,-66.30291332360267,-1.546532127360038,-1.5458571596300121,-0.0034706717105630336,194615100.0,-1.0
293,2022-03-04,AMD,112.0,113.0,106.80999755859376,108.41000366210938,100609400.0,0.0,0.0,-3.5699996948242188,3.5699996948242188,0.0,38.259080490169026,104.26000213623048,124.61000061035156,20.393129420409608,-79.60687057959039,-2.0724400747545104,-1.6511809106179678,-0.04761484741948441,94005700.0,-1.0
294,2022-03-07,AMD,108.52999877929688,109.52999877929688,102.81999969482422,102.9499969482422,92600000.0,0.0,0.0,-5.460006713867173,5.460006713867173,0.0,32.691120944922844,102.81999969482422,124.61000061035156,0.5965913169161373,-99.40340868308385,-2.8824136358514068,-1.8974408633317894,-0.10981413238282434,1405700.0,-1.0
295,2022-03-08,AMD,102.80999755859376,109.9000015258789,100.08000183105467,105.52999877929688,135348300.0,0.0,0.0,2.5800018310546733,0.0,2.5800018310546733,37.63931965712074,100.08000183105467,124.61000061035156,22.217681285993184,-77.78231871400682,-3.2838035392078524,-2.174725475955232,-0.03853865957184899,136754000.0,1.0
296,2022-03-09,AMD,108.41000366210938,111.70999908447266,106.8499984741211,111.0500030517578,102310300.0,0.0,0.0,5.520004272460923,0.0,5.520004272460923,47.21841522668014,100.08000183105467,124.61000061035156,44.72075730375377,-55.27924269624622,-3.132020638736023,-2.366191180117457,-0.04768028067483088,239064300.0,1.0
297,2022-03-10,AMD,108.88999938964844,109.06999969482422,103.06999969482422,106.45999908447266,102557400.0,0.0,0.0,-4.590003967285142,4.590003967285142,0.0,41.153289953734884,100.08000183105467,124.61000061035156,26.00895870733857,-73.99104129266144,-3.334362991647538,-2.559830940312164,-0.12060134452798599,136506900.0,-1.0
298,2022-03-11,AMD,108.12999725341795,108.19000244140624,104.08000183105467,104.29000091552734,87584400.0,0.0,0.0,-2.1699981689453125,2.1699981689453125,0.0,38.45855796539081,100.08000183105467,124.61000061035156,17.162655091633653,-82.83734490836635,-3.6238036781124947,-2.772630233455045,-0.15445107822263682,48922500.0,-1.0
299,2022-03-14,AMD,102.98999786376952,105.23999786376952,101.04000091552734,102.25,89731700.0,0.0,0.0,-2.0400009155273438,2.0400009155273438,0.0,35.908077107134844,100.08000183105467,124.61000061035156,8.846303615704974,-91.15369638429502,-3.9683111774080544,-3.0117706886539337,-0.10173066542019027,-40809200.0,-1.0
300,2022-03-15,AMD,102.66000366210938,109.69000244140624,101.79000091552734,109.33000183105467,112425500.0,0.0,0.0,7.080001831054673,0.0,7.080001831054673,49.357291377033924,100.08000183105467,124.61000061035156,37.70892971999217,-62.29107028000783,-3.6391492323196246,-3.1372481882617897,-0.07566788164195315,71616300.0,1.0
301,2022-03-16,AMD,111.5999984741211,115.41999816894533,109.88999938964844,115.37000274658205,113689800.0,0.0,0.0,6.040000915527372,0.0,6.040000915527372,58.02717640712298,100.08000183105467,124.61000061035156,62.33184539916081,-37.66815460083918,-2.8667432611603942,-3.0831465851104047,0.030273256724621778,185306100.0,1.0
302,2022-03-17,AMD,112.13999938964844,114.2699966430664,109.70999908447266,111.69000244140624,103201700.0,0.0,0.0,-3.6800003051758097,3.6800003051758097,0.0,51.7936771138538,100.08000183105467,124.61000061035156,47.329805088087916,-52.670194911912084,-2.517569123615715,-2.9700300595615463,0.030255499202083813,82104400.0,-1.0
303,2022-03-18,AMD,111.27999877929688,114.93000030517578,110.5500030517578,113.45999908447266,105834800.0,0.0,0.0,1.7699966430664205,0.0,1.7699966430664205,54.505915751416076,100.08000183105467,122.43000030517578,59.865763610277554,-40.134236389722446,-2.076326630868934,-2.7912880676644547,0.10208841619989872,187939200.0,1.0
304,2022-03-21,AMD,113.7300033569336,117.56999969482422,112.54000091552734,115.91999816894533,101905900.0,0.0,0.0,2.4599990844726705,0.0,2.4599990844726705,58.270980767959784,100.08000183105467,119.4800033569336,81.64945923721014,-18.350540762789866,-1.5136007816758053,-2.5357491165843435,0.0984554108768434,289845100.0,1.0
305,2022-03-22,AMD,115.43000030517578,117.9499969482422,113.80999755859376,114.77999877929688,101672600.0,0.0,0.0,-1.1399993896484517,1.1399993896484517,0.0,55.80163417848993,100.08000183105467,118.26000213623048,80.85806766492266,-19.141932335077342,-1.145237690542416,-2.2576455307396506,0.033588434264163025,188172500.0,-1.0
306,2022-03-23,AMD,114.29000091552734,117.5500030517578,112.20999908447266,113.91999816894533,90579200.0,0.0,0.0,-0.8600006103515483,0.8600006103515483,0.0,53.81651166960051,100.08000183105467,117.9499969482422,77.44823793812465,-22.55176206187535,-0.9113589358658771,-1.9883872043498947,0.07007325895760519,97593300.0,-1.0
307,2022-03-24,AMD,114.95999908447266,120.5500030517578,113.70999908447266,120.52999877929688,121961300.0,0.0,0.0,6.610000610351548,0.0,6.610000610351548,64.8926639763088,100.08000183105467,120.5500030517578,99.90227517700052,-0.09772482299947884,-0.19654704952665725,-1.6300181007308463,0.15571960610992397,219554600.0,1.0
308,2022-03-25,AMD,119.91999816894533,121.4000015258789,117.25,119.66999816894533,95852400.0,0.0,0.0,-0.8600006103515483,0.8600006103515483,0.0,62.637481740704494,100.08000183105467,121.4000015258789,91.88553760930135,-8.114462390698652,0.29777659421574754,-1.244458238509075,0.17036673025863402,123702200.0,-1.0
309,2022-03-28,AMD,117.6999969482422,120.41000366210938,116.70999908447266,120.23999786376952,92966100.0,0.0,0.0,0.5699996948241903,0.0,0.5699996948241903,63.60476644385115,101.04000091552734,121.4000015258789,94.30253621151851,-5.697463788481484,0.7266320652204286,-0.8502394225899526,0.09978958977402952,216668300.0,1.0
310,2022-03-29,AMD,122.27999877929688,123.70999908447266,119.58999633789062,123.2300033569336,94143000.0,0.0,0.0,2.9900054931640767,0.0,2.9900054931640767,68.53523253005744,101.04000091552734,123.70999908447266,97.88268298937673,-2.117317010623268,1.2906229310536759,-0.4220662956878192,0.06812863329488317,310811300.0,1.0
311,2022-03-30,AMD,123.04000091552734,125.66999816894533,118.58999633789062,119.22000122070312,99476900.0,0.0,0.0,-4.010002136230469,4.010002136230469,0.0,56.65777457197436,101.04000091552734,125.66999816894533,73.81243334346244,-26.18756665653755,1.4005465154202597,-0.05754328656229473,0.06741873591816971,211334400.0,-1.0
312,2022-03-31,AMD,116.30999755859376,116.37999725341795,109.0199966430664,109.33999633789062,147004800.0,0.0,0.0,-9.8800048828125,9.8800048828125,0.0,37.95693197672448,101.04000091552734,125.66999816894533,33.698726544565346,-66.30127345543465,0.6887312604301741,0.09171176922513177,-0.03631238127822145,64329600.0,-1.0
313,2022-04-01,AMD,110.4800033569336,111.41999816894533,106.0999984741211,108.19000244140624,111867100.0,0.0,0.0,-1.1499938964843892,1.1499938964843892,0.0,36.345760708613696,101.79000091552734,125.66999816894533,26.800679489034906,-73.1993205109651,0.03217117068369646,0.07980364017327751,-0.0666838841411398,-47537500.0,-1.0
314,2022-04-04,AMD,109.97000122070312,110.94000244140624,107.02999877929688,110.52999877929688,90123900.0,0.0,0.0,2.339996337890639,0.0,2.339996337890639,42.114584952322645,106.0999984741211,125.66999816894533,22.636690721806215,-77.3633092781938,-0.29713935006694214,0.004414994803013932,-0.03702735707614058,42586400.0,1.0
315,2022-04-05,AMD,109.69000244140624,110.4800033569336,106.0500030517578,106.81999969482422,79532000.0,0.0,0.0,-3.7099990844726562,3.7099990844726562,0.0,36.12526459309526,106.0500030517578,125.66999816894533,3.9245506355497874,-96.07544936445022,-0.8458399765644344,-0.16563608486470988,-0.06232442580969577,-36945600.0,-1.0
316,2022-04-06,AMD,104.4499969482422,105.73999786376952,101.70999908447266,103.66999816894533,105256600.0,0.0,0.0,-3.150001525878892,3.150001525878892,0.0,31.707595372352714,101.70999908447266,125.66999816894533,8.180296992343594,-91.8197030076564,-1.515880098479343,-0.43568499607560374,-0.1398821934879796,-142202200.0,-1.0
317,2022-04-07,AMD,103.91999816894533,105.23999786376952,100.91000366210938,103.72000122070312,91895500.0,0.0,0.0,0.05000305175779829,0.0,0.05000305175779829,31.860217167023748,100.91000366210938,125.66999816894533,11.348942576776185,-88.65105742322382,-2.019544496746221,-0.7524569980163235,-0.13328317199206963,-50306700.0,1.0
318,2022-04-08,AMD,102.51000213623048,102.98999786376952,100.41999816894533,101.0,92746700.0,0.0,0.0,-2.720001220703125,2.720001220703125,0.0,27.940942520507562,100.41999816894533,125.66999816894533,2.2970369546719733,-97.70296304532803,-2.6069978378373833,-1.123365261344791,-0.1600132917963638,-143053400.0,-1.0
319,2022-04-11,AMD,98.5999984741211,98.66999816894533,95.94000244140624,97.37000274658205,95527700.0,0.0,0.0,-3.6299972534179545,3.6299972534179545,0.0,23.49109325813707,95.94000244140624,125.66999816894533,4.809957990848923,-95.19004200915107,-3.3257362529009242,-1.563839550256324,-0.20985149643669565,-238581100.0,-1.0
320,2022-04-12,AMD,98.77999877929688,99.58999633789062,94.5999984741211,95.0999984741211,89246400.0,0.0,0.0,-2.2700042724609517,2.2700042724609517,0.0,21.069872242292362,94.5999984741211,125.66999816894533,1.6092694075027367,-98.39073059249726,-4.03120515288893,-2.0573127519840857,-0.20231506877717997,-327827500.0,-1.0
321,2022-04-13,AMD,95.3000030517578,98.33000183105467,94.70999908447266,97.73999786376952,77728400.0,0.0,0.0,2.6399993896484233,0.0,2.6399993896484233,30.660304744752253,94.5999984741211,125.66999816894533,10.106209914676946,-89.89379008532306,-4.328155588788036,-2.511481379131799,-0.1060910816045203,-250099100.0,1.0
322,2022-04-14,AMD,98.37000274658205,98.38999938964844,92.91999816894533,93.05999755859376,73354400.0,0.0,0.0,-4.680000305175753,4.680000305175753,0.0,24.557049481191925,92.91999816894533,125.66999816894533,0.4274790523616412,-99.57252094763835,-4.883417742075991,-2.985868701679453,-0.13984660820214523,-323453500.0,-1.0
323,2022-04-18,AMD,92.02999877929688,95.16000366210938,91.63999938964844,93.88999938964844,80605800.0,0.0,0.0,0.8300018310546733,0.0,0.8300018310546733,27.509922078513583,91.63999938964844,125.66999816894533,6.611813343257747,-93.38818665674225,-5.19676324590975,-3.4280476477790147,-0.15054735884757142,-242847700.0,1.0
324,2022-04-19,AMD,93.38999938964844,97.06999969482422,92.83999633789062,96.93000030517578,77069500.0,0.0,0.0,3.0400009155273438,0.0,3.0400009155273438,37.79878707604676,91.63999938964844,125.66999816894533,15.545110506279727,-84.45488949372027,-5.141249909591792,-3.7706881232354923,-0.09258565266713481,-165778200.0,1.0
325,2022-04-20,AMD,97.83999633789062,97.91000366210938,93.1999969482422,94.0199966430664,62489000.0,0.0,0.0,-2.910003662109375,2.910003662109375,0.0,32.67621196915857,91.63999938964844,116.37999725341795,9.620038233323193,-90.37996176667681,-5.270606611881277,-4.070671837139739,-0.09308384003395886,-228267200.0,-1.0
326,2022-04-21,AMD,95.16000366210938,96.2300033569336,89.23999786376953,89.8499984741211,76680600.0,0.0,0.0,-4.1699981689453125,4.1699981689453125,0.0,26.694533757580558,89.23999786376953,111.41999816894533,2.7502281422837327,-97.24977185771627,-5.643619370691823,-4.385261357420262,-0.13372543948460247,-304947800.0,-1.0
327,2022-04-22,AMD,90.02999877929688,91.45999908447266,87.94000244140625,88.13999938964844,75017700.0,0.0,0.0,-1.7099990844726562,1.7099990844726562,0.0,24.566662170815803,87.94000244140625,110.94000244140624,0.8695519488790767,-99.13044805112092,-6.0075875766149665,-4.7097266124560875,-0.12732673871635214,-379965500.0,-1.0
328,2022-04-25,AMD,89.86000061035156,91.37000274658205,88.61000061035156,90.69000244140624,93481000.0,0.0,0.0,2.5500030517577983,0.0,2.5500030517577983,33.664935144113784,87.94000244140625,110.4800033569336,12.20053189130781,-87.7994681086922,-6.021299314925557,-4.972041160191695,-0.06860429410237745,-286484500.0,1.0
329,2022-04-26,AMD,89.73999786376953,90.12000274658205,85.08000183105469,85.16000366210938,89127400.0,0.0,0.0,-5.529998779296861,5.529998779296861,0.0,25.860178061393654,85.08000183105469,105.73999786376952,0.3872306215742039,-99.6127693784258,-6.403600996567889,-5.258353133790302,-0.10452150338064015,-375611900.0,-1.0
330,2022-04-27,AMD,84.25,87.9000015258789,84.0199966430664,84.91000366210938,83125100.0,0.0,0.0,-0.25,0.25,0.0,25.55118021436094,84.0199966430664,105.23999786376952,4.194189292386285,-95.80581070761372,-6.650022336346879,-5.5366869792193505,-0.13126656928663583,-458737000.0,-1.0
331,2022-04-28,AMD,86.66999816894531,90.58000183105467,84.77999877929688,89.63999938964844,91495400.0,0.0,0.0,4.7299957275390625,0.0,4.7299957275390625,40.95351723677237,84.0199966430664,102.98999786376952,29.625737400842027,-70.37426259915797,-6.390642943971997,-5.707478174583974,-0.0367504648470679,-367241600.0,1.0
332,2022-04-29,AMD,88.05000305175781,91.79000091552734,85.37999725341797,85.5199966430664,82647700.0,0.0,0.0,-4.120002746582031,4.120002746582031,0.0,33.90393239165732,84.0199966430664,99.58999633789062,9.63391155684242,-90.36608844315758,-6.44268874825481,-5.854520290980867,-0.08914690383419943,-449889300.0,-1.0
333,2022-05-02,AMD,85.66000366210938,90.37000274658205,85.31999969482422,89.83999633789062,98304100.0,0.0,0.0,4.319999694824219,0.0,4.319999694824219,45.29649895959266,84.0199966430664,99.58999633789062,37.37957488052427,-62.62042511947573,-6.065948159413026,-5.896805865049825,-0.07314560966638695,-351585200.0,1.0
334,2022-05-03,AMD,89.8499984741211,92.20999908447266,89.01000213623047,91.12999725341795,126381800.0,0.0,0.0,1.2900009155273295,0.0,1.2900009155273295,48.363120296930454,84.0199966430664,98.38999938964844,49.47807412244715,-50.52192587755285,-5.598885659619384,-5.837221823532527,-0.030738135426870095,-225203400.0,1.0
335,2022-05-04,AMD,98.18000030517578,99.69000244140624,91.6999969482422,99.41999816894533,225394100.0,0.0,0.0,8.290000915527372,0.0,8.290000915527372,63.52499387661894,84.0199966430664,99.69000244140624,98.27693572079268,-1.7230642792073179,-4.50871644111227,-5.571520745510171,0.10651084983135095,190700.0,1.0
336,2022-05-05,AMD,97.6500015258789,97.83999633789062,92.16999816894533,93.87000274658205,153129800.0,0.0,0.0,-5.549995422363281,5.549995422363281,0.0,51.78026265505245,84.0199966430664,99.69000244140624,62.85898186814459,-37.14101813185541,-4.0454029457597045,-5.266297184146379,0.06501024956447377,-152939100.0,-1.0
337,2022-05-06,AMD,94.33999633789062,98.18000030517578,92.6500015258789,95.33999633789062,144286600.0,0.0,0.0,1.4699935913085795,0.0,1.4699935913085795,54.35909675558073,84.0199966430664,99.69000244140624,72.23992026871825,-27.760079731281756,-3.519173694101781,-4.91687248484272,0.051273500620850676,-8652500.0,1.0
338,2022-05-09,AMD,92.87000274658205,93.73999786376952,85.37999725341797,86.36000061035156,144523700.0,0.0,0.0,-8.979995727539062,8.979995727539062,0.0,39.477319102959626,84.0199966430664,99.69000244140624,14.9330127722931,-85.0669872277069,-3.782371265193831,-4.689972240240348,0.014091086151234,-153176200.0,-1.0
339,2022-05-10,AMD,89.18000030517578,90.7699966430664,85.41000366210938,88.7300033569336,137235500.0,0.0,0.0,2.3700027465820312,0.0,2.3700027465820312,44.13473547252223,84.0199966430664,99.69000244140624,30.057466311634627,-69.94253368836537,-3.7565927994603925,-4.503296351641669,0.04498880614851353,-15940700.0,1.0
340,2022-05-11,AMD,87.83999633789062,93.45999908447266,86.52999877929688,87.91999816894531,136137900.0,0.0,0.0,-0.8100051879882812,0.8100051879882812,0.0,42.83483278425343,84.0199966430664,99.69000244140624,24.888322161897953,-75.11167783810204,-3.7581366184454055,-4.354264404719682,-0.019187876309844643,-152078600.0,-1.0
341,2022-05-12,AMD,86.5999984741211,88.55000305175781,83.2699966430664,87.05999755859375,129214200.0,0.0,0.0,-0.8600006103515625,0.8600006103515625,0.0,41.34309607760413,83.2699966430664,99.69000244140624,23.081605220325425,-76.91839477967457,-3.7850586403867936,-4.240423251680327,0.01800749504183008,-281292800.0,-1.0
342,2022-05-13,AMD,88.30000305175781,96.56999969482422,88.22000122070312,95.12000274658205,138068100.0,0.0,0.0,8.060005187988295,0.0,8.060005187988295,57.38999600019674,83.2699966430664,99.69000244140624,72.16809938467715,-27.831900615322848,-3.1205502757851633,-4.016448656229352,0.05877122243898114,-143224700.0,1.0
343,2022-05-16,AMD,93.86000061035156,98.16999816894533,93.08000183105467,94.23999786376952,131065700.0,0.0,0.0,-0.8800048828125284,0.8800048828125284,0.0,55.47798513735399,83.2699966430664,99.69000244140624,66.80875363522863,-33.19124636477138,-2.6345120014636336,-3.7400613250077437,0.03412707894309652,-274290400.0,-1.0
344,2022-05-17,AMD,97.87999725341795,103.1999969482422,97.54000091552734,102.47000122070312,164227200.0,0.0,0.0,8.230003356933608,0.0,8.230003356933608,67.25154534914951,83.2699966430664,103.1999969482422,96.33720162387806,-3.6627983761219403,-1.5676053403163905,-3.3055701277318437,0.030677963266252606,-110063200.0,1.0
345,2022-05-18,AMD,100.0,104.22000122070312,95.70999908447266,96.27999877929688,142603200.0,0.0,0.0,-6.19000244140625,6.19000244140625,0.0,54.698546250468226,83.2699966430664,104.22000122070312,62.10023529120428,-37.89976470879572,-1.2073333535457778,-2.885922772633755,0.025673761182483545,-252666400.0,-1.0
346,2022-05-19,AMD,96.69000244140624,100.69000244140624,95.08999633789062,96.66999816894533,141506200.0,0.0,0.0,0.3899993896484517,0.0,0.3899993896484517,55.305037887356455,83.2699966430664,104.22000122070312,63.961807150070406,-36.03819284992959,-0.8802178342956353,-2.4847817847666347,0.013950093162801158,-111160200.0,1.0
347,2022-05-20,AMD,98.38999938964844,98.63999938964844,88.26000213623047,93.5,164126800.0,0.0,0.0,-3.1699981689453267,3.1699981689453267,0.0,49.13552003540235,83.2699966430664,104.22000122070312,48.830554279943726,-51.169445720056274,-0.8666435329512723,-2.161154134274804,0.08267715770248163,-275287000.0,-1.0
348,2022-05-23,AMD,91.66000366210938,95.19000244140624,90.91999816894533,95.06999969482422,128773000.0,0.0,0.0,1.5699996948242188,0.0,1.5699996948242188,52.18376834267377,83.2699966430664,104.22000122070312,56.32458459867755,-43.675415401322454,-0.7209509324224683,-1.8731134938126572,0.07145267776432696,-146514000.0,1.0
349,2022-05-24,AMD,92.54000091552734,93.41999816894533,89.62000274658203,91.16000366210938,123341400.0,0.0,0.0,-3.9099960327148438,3.9099960327148438,0.0,44.517392497861614,83.2699966430664,104.22000122070312,37.66112312674734,-62.33887687325266,-0.9103547013134374,-1.6805617352637843,0.03685174659510504,-269855400.0,-1.0
350,2022-05-25,AMD,90.43000030517578,93.88999938964844,89.5199966430664,92.6500015258789,111771100.0,0.0,0.0,1.4899978637695312,0.0,1.4899978637695312,47.88393077889095,83.2699966430664,104.22000122070312,44.77328321362409,-55.22671678637591,-0.9295619799434149,-1.530361784169114,0.06420863914592845,-158084300.0,1.0
351,2022-05-26,AMD,91.33999633789062,100.33000183105467,90.73999786376952,98.75,128792700.0,0.0,0.0,6.099998474121094,0.0,6.099998474121094,59.4940671238173,83.2699966430664,104.22000122070312,73.89021467545582,-26.109785324544177,-0.4475970331822481,-1.3138088339364506,0.03816229130153581,-29291600.0,1.0
352,2022-05-27,AMD,100.13999938964844,102.4000015258789,99.37999725341795,102.26000213623048,104348400.0,0.0,0.0,3.510002136230483,0.0,3.510002136230483,64.71325392557267,83.2699966430664,104.22000122070312,90.64439782240018,-9.355602177599815,0.21500898794181467,-1.0080452695209352,0.08510191483720586,75056800.0,1.0
353,2022-05-31,AMD,102.43000030517578,104.5500030517578,100.04000091552734,101.86000061035156,125102900.0,0.0,0.0,-0.40000152587892046,0.40000152587892046,0.0,63.63509429045425,83.2699966430664,104.5500030517578,87.3590148905803,-12.640985109419695,0.699793851016878,-0.6664774453777483,-0.005952967727966829,-50046100.0,-1.0
354,2022-06-01,AMD,102.12999725341795,103.56999969482422,99.5500030517578,101.22000122070312,99351400.0,0.0,0.0,-0.6399993896484375,0.6399993896484375,0.0,61.73622224960559,83.2699966430664,104.5500030517578,84.35149986752542,-15.648500132474588,1.0205960127173057,-0.32906275373058474,0.051308709015776444,-149397500.0,-1.0
355,2022-06-02,AMD,100.77999877929688,109.5,100.77999877929688,108.58999633789062,120953800.0,0.0,0.0,7.3699951171875,0.0,7.3699951171875,72.60007604986068,88.22000122070312,109.5,95.7236667560587,-4.276333243941299,1.8480554373741427,0.106360884519425,0.1233060762876328,-28443700.0,1.0
356,2022-06-03,AMD,105.8000030517578,109.38999938964844,104.6500015258789,106.3000030517578,110844700.0,0.0,0.0,-2.2899932861328267,2.2899932861328267,0.0,65.89276124934268,88.26000213623047,109.5,84.93409948171112,-15.065900518288883,2.292657308600184,0.5436201693589262,0.13689842836104593,-139288400.0,-1.0
357,2022-06-06,AMD,108.2699966430664,109.56999969482422,104.2300033569336,105.6500015258789,96726900.0,0.0,0.0,-0.650001525878892,0.650001525878892,0.0,63.957536474103534,88.26000213623047,109.56999969482422,81.60488682287773,-18.39511317712227,2.5630235912561403,0.9475008537556227,0.11128644014953837,-236015300.0,-1.0
358,2022-06-07,AMD,104.23999786376952,106.23999786376952,102.61000061035156,105.27999877929688,79022900.0,0.0,0.0,-0.37000274658203125,0.37000274658203125,0.0,62.747144176992535,88.26000213623047,109.56999969482422,79.86859968551568,-20.131400314484324,2.7161299088241293,1.3012266647814128,0.15489243692358978,-315038200.0,-1.0
359,2022-06-08,AMD,104.56999969482422,105.8499984741211,100.41000366210938,101.9000015258789,97641900.0,0.0,0.0,-3.3799972534179688,3.3799972534179688,0.0,52.31206809385256,88.26000213623047,109.56999969482422,64.00751268105046,-35.99248731894954,2.535558091343006,1.5480929501004812,0.09983809873350413,-412680100.0,-1.0
360,2022-06-09,AMD,101.56999969482422,103.94000244140624,98.73999786376952,98.8000030517578,95299000.0,0.0,0.0,-3.099998474121108,3.099998474121108,0.0,44.483326604659034,88.26000213623047,109.56999969482422,49.46035721752972,-50.53964278247028,2.117943668599736,1.662063093802825,0.0005063600178005778,-507979100.0,-1.0
361,2022-06-10,AMD,98.81999969482422,99.93000030517578,94.25,94.81999969482422,102135400.0,0.0,0.0,-3.9800033569335795,3.9800033569335795,0.0,36.4110941819737,89.5199966430664,109.56999969482422,26.43392640926882,-73.56607359073118,1.4491811724034136,1.6194867095221976,-0.07275574306652877,-610114500.0,-1.0
362,2022-06-13,AMD,91.26000213623048,92.02999877929688,86.63999938964844,86.98999786376953,98148800.0,0.0,0.0,-7.8300018310546875,7.8300018310546875,0.0,25.788184293628817,86.63999938964844,109.56999969482422,1.5263779741079715,-98.47362202589203,0.2841969456993496,1.3524287567538897,-0.14598471095110965,-708263300.0,-1.0
363,1.0,1.0,1.0,1.0,1.0,1.0,1.0,1.0,1.0,1.0,1.0,1.0,1.0,1.0,1.0,1.0,1.0,1.0,1.0,1.0,1.0,1.0
364,2022-06-15,AMD,87.9000015258789,90.86000061035156,86.19000244140625,89.30000305175781,95774800.0,0.0,0.0,2.3100051879882812,0.0,2.3100051879882812,33.41799150518749,85.81999969482422,109.56999969482422,14.652645713404604,-85.34735428659539,-1.1579715949133913,0.5328757766337797,-0.17764061089117011,-612488500.0,1.0
365,2022-06-16,AMD,86.62999725341797,86.7300033569336,80.63999938964844,82.05000305175781,102433300.0,0.0,0.0,-7.25,7.25,0.0,24.35150115488092,80.63999938964844,109.56999969482422,4.873845998049006,-95.126154001951,-2.1353057245628406,-0.0007605236093689678,-0.2281279332437327,-714921800.0,-1.0
366,2022-06-17,AMD,82.19000244140625,82.94000244140625,79.43000030517578,81.56999969482422,105212300.0,0.0,0.0,-0.48000335693359375,0.48000335693359375,0.0,23.85704288442311,79.43000030517578,109.56999969482422,7.100197189729933,-92.89980281027007,-2.914973807574029,-0.5836031804056427,-0.22792239927375968,-820134100.0,-1.0
367,2022-06-21,AMD,84.16999816894531,85.80999755859375,82.5999984741211,83.79000091552734,87780600.0,0.0,0.0,2.220001220703125,0.0,2.220001220703125,31.30111297162074,79.43000030517578,109.56999969482422,14.46582846265419,-85.53417153734581,-3.315530359377121,-1.1299886162024446,-0.20412232250135154,-732353500.0,1.0
368,2022-06-22,AMD,84.4000015258789,86.37999725341797,83.30000305175781,83.75,86634700.0,0.0,0.0,-0.04000091552734375,0.04000091552734375,0.0,31.237620346797215,79.43000030517578,109.56999969482422,14.33311142105703,-85.66688857894297,-3.5947624321036358,-1.6229433793844916,-0.17811581211085126,-818988200.0,-1.0
369,2022-06-23,AMD,84.31999969482422,84.41000366210938,80.2300033569336,82.43000030517578,100614600.0,0.0,0.0,-1.3199996948242188,1.3199996948242188,0.0,28.997957160496654,79.43000030517578,109.56999969482422,9.953550301100364,-90.04644969889964,-3.8778559341867123,-2.0739258903462594,-0.165688281790906,-919602800.0,-1.0
370,2022-06-24,AMD,83.55999755859375,87.52999877929688,83.08000183105469,87.08000183105469,88553900.0,0.0,0.0,4.650001525878906,0.0,4.650001525878906,45.02053671027003,79.43000030517578,109.56999969482422,25.38155833044341,-74.61844166955659,-3.6845531365461994,-2.396051339587004,-0.08162832618308924,-831048900.0,1.0
371,2022-06-27,AMD,87.36000061035156,88.22000122070312,85.25,86.16000366210938,74663500.0,0.0,0.0,-0.9199981689453125,0.9199981689453125,0.0,42.81487913935566,79.43000030517578,106.23999786376952,25.102588473665648,-74.89741152633435,-3.5644994706798343,-2.629740965806009,-0.009541260168323795,-905712400.0,-1.0
372,2022-06-28,AMD,85.70999908447266,86.7300033569336,80.43000030517578,80.77999877929688,95618600.0,0.0,0.0,-5.3800048828125,5.3800048828125,0.0,32.17770810697685,79.43000030517578,105.8499984741211,5.10975990796212,-94.89024009203789,-3.858959688920862,-2.875584710429349,-0.07138750703497898,-1001331000.0,-1.0
373,2022-06-29,AMD,79.55000305175781,79.75,76.51000213623047,77.98999786376953,104140900.0,0.0,0.0,-2.7900009155273438,2.7900009155273438,0.0,28.01319989496659,76.51000213623047,103.94000244140624,5.395536679085644,-94.60446332091436,-4.268232832637537,-3.1541143348713216,-0.1266517894902317,-1105471900.0,-1.0
374,2022-06-30,AMD,77.7300033569336,78.91000366210938,75.4800033569336,76.47000122070312,105368600.0,0.0,0.0,-1.5199966430664062,1.5199966430664062,0.0,25.905598689565494,75.4800033569336,99.93000030517578,4.0490715228523015,-95.9509284771477,-4.661492014788308,-3.455589870855009,-0.06800733240113077,-1210840500.0,-1.0
375,2022-07-01,AMD,75.19000244140625,75.44999694824219,72.69000244140625,73.66999816894531,87734200.0,0.0,0.0,-2.8000030517578125,2.8000030517578125,0.0,22.334047095758706,72.69000244140625,92.02999877929688,5.067197068797111,-94.93280293120289,-5.139826161797785,-3.7924371290438232,-0.09684935093091807,-1298574700.0,-1.0
376,2022-07-05,AMD,71.9800033569336,75.20999908447266,71.5999984741211,75.19999694824219,95589000.0,0.0,0.0,1.529998779296875,0.0,1.529998779296875,28.545239058359655,71.5999984741211,90.86000061035156,18.691578789334855,-81.30842121066514,-5.333970822219797,-4.100743867679207,-0.10251824649035568,-1202985700.0,1.0
377,2022-07-06,AMD,75.16999816894531,76.27999877929688,73.55000305175781,75.3499984741211,85458900.0,0.0,0.0,0.15000152587890625,0.0,0.15000152587890625,29.185882848891566,71.5999984741211,90.86000061035156,19.470402824856293,-80.5295971751437,-5.413326540054456,-4.363260402154386,-0.10029852568213615,-1117526800.0,1.0
378,2022-07-07,AMD,77.19000244140625,79.98999786376953,76.9000015258789,79.30000305175781,83640900.0,0.0,0.0,3.9500045776367188,0.0,3.9500045776367188,44.34679850851623,71.5999984741211,88.22000122070312,46.32974311162647,-53.67025688837354,-5.098724298619288,-4.510353181447424,-0.03797157881632851,-1033885900.0,1.0
379,2022-07-08,AMD,78.30999755859375,80.47000122070312,77.4000015258789,79.3499984741211,83405900.0,0.0,0.0,0.04999542236328125,0.0,0.04999542236328125,44.52026695886056,71.5999984741211,88.22000122070312,46.63055787757808,-53.36944212242193,-4.790147599208709,-4.566312064999698,-0.0887689847771328,-950480000.0,1.0
380,2022-07-11,AMD,77.8499984741211,78.29000091552734,75.83999633789062,76.94999694824219,76150300.0,0.0,0.0,-2.4000015258789062,2.4000015258789062,0.0,37.96561072396185,71.5999984741211,88.22000122070312,32.19011786999459,-67.80988213000542,-4.685241491802913,-4.590097950360348,-0.10689422379768854,-1026630300.0,-1.0
381,2022-07-12,AMD,76.9800033569336,77.44000244140625,74.43000030517578,76.36000061035156,77873200.0,0.0,0.0,-0.589996337890625,0.589996337890625,0.0,36.44366249137241,71.5999984741211,88.22000122070312,28.6402006594697,-71.3597993405303,-4.596720141985372,-4.591422388685353,-0.05471649214827812,-1104503500.0,-1.0
382,2022-07-13,AMD,74.94000244140625,79.11000061035156,74.4800033569336,77.5199966430664,79355000.0,0.0,0.0,1.1599960327148438,0.0,1.1599960327148438,41.741782344580905,71.5999984741211,88.22000122070312,35.6197183551175,-64.3802816448825,-4.382449290398739,-4.549627769028024,-0.006026429459891847,-1025148500.0,1.0
383,2022-07-14,AMD,78.2300033569336,79.25,76.0,78.5999984741211,83493600.0,0.0,0.0,1.0800018310546875,0.0,1.0800018310546875,46.53015291255506,71.5999984741211,88.22000122070312,42.11792324426406,-57.88207675573594,-4.078479503647472,-4.455398115951902,0.027854024054092763,-941654900.0,1.0
384,2022-07-15,AMD,79.36000061035156,81.19999694824219,77.9000015258789,81.11000061035156,76050600.0,0.0,0.0,2.5100021362304688,0.0,2.5100021362304688,56.1869216917919,71.5999984741211,88.22000122070312,57.220220003791745,-42.779779996208255,-3.593626083413227,-4.283043709444149,0.10099094103876993,-865604300.0,1.0
385,2022-07-18,AMD,82.20999908447266,84.47000122070312,80.94000244140625,81.43000030517578,90464300.0,0.0,0.0,0.31999969482421875,0.0,0.31999969482421875,57.32079006508425,71.5999984741211,86.7300033569336,64.9702489007221,-35.0297510992779,-3.147275804806071,-4.0558901285165145,0.08284579268296399,-775140000.0,1.0
386,2022-07-19,AMD,82.76000213623047,86.41000366210938,82.19000244140625,85.87999725341797,85047500.0,0.0,0.0,4.4499969482421875,0.0,4.4499969482421875,69.84349071043805,71.5999984741211,86.41000366210938,96.42129491540442,-3.578705084595583,-2.4067286184289856,-3.726057826498987,0.1397478300270092,-690092500.0,1.0
387,2022-07-20,AMD,85.38999938964844,89.91999816894531,85.08000183105469,89.43000030517578,88348600.0,0.0,0.0,3.5500030517578125,0.0,3.5500030517578125,76.25628394841016,71.5999984741211,89.91999816894531,97.32533912700902,-2.674660872990985,-1.5159166056178321,-3.284029582322733,0.12774270950287714,-601743900.0,1.0
388,2022-07-21,AMD,89.5999984741211,91.58000183105467,88.22000122070312,91.08999633789062,90449300.0,0.0,0.0,1.6599960327148438,0.0,1.6599960327148438,78.70010732115546,71.5999984741211,91.58000183105467,97.54752046628658,-2.4524795337134098,-0.6682933708531209,-2.7608823400287883,0.14795208682453054,-511294600.0,1.0
389,2022-07-22,AMD,90.1999969482422,90.69000244140624,87.04000091552734,88.0999984741211,76989700.0,0.0,0.0,-2.9899978637695312,2.9899978637695312,0.0,64.83186625463762,71.5999984741211,91.58000183105467,82.5825687074976,-17.4174312925024,-0.2350987124487176,-2.255725614512757,0.14489931082620555,-588284300.0,-1.0
390,2022-07-25,AMD,86.56999969482422,87.5999984741211,85.12000274658203,87.54000091552734,70083000.0,0.0,0.0,-0.55999755859375,0.55999755859375,0.0,62.45356716821139,73.55000305175781,91.58000183105467,77.59289412616987,-22.40710587383014,0.06230662011603272,-1.7921191675869867,0.14641173671834928,-658367300.0,-1.0
391,2022-07-26,AMD,87.0,87.75,84.70999908447266,85.25,69180400.0,0.0,0.0,-2.2900009155273438,2.2900009155273438,0.0,53.238451519774856,74.43000030517578,91.58000183105467,63.09037161598574,-36.909628384014255,0.1119315433059711,-1.411309025408387,0.09971624989260097,-727547700.0,-1.0
392,2022-07-27,AMD,86.94000244140625,90.62000274658205,86.29000091552734,89.81999969482422,78301600.0,0.0,0.0,4.569999694824219,0.0,4.569999694824219,65.09706494454514,74.43000030517578,91.58000183105467,89.7375977863637,-10.2624022136363,0.5140881908831716,-1.0262295821500689,0.14274810990482778,-649246100.0,1.0
393,2022-07-28,AMD,90.41999816894533,92.22000122070312,88.58999633789062,91.66999816894533,79009200.0,0.0,0.0,1.849998474121108,0.0,1.849998474121108,68.79357698272506,74.43000030517578,92.22000122070312,96.90835849661059,-3.091641503389404,0.970885501877973,-0.6268065653444549,0.13019353321575555,-570236900.0,1.0
394,2022-07-29,AMD,90.6999969482422,94.80999755859376,90.55999755859376,94.47000122070312,76630700.0,0.0,0.0,2.8000030517577983,0.0,2.8000030517577983,73.66445759034926,74.43000030517578,94.80999755859376,98.33171548718626,-1.6682845128137471,1.5410696949838183,-0.19323131327879556,0.16013755208961378,-493606200.0,1.0
395,2022-08-01,AMD,95.58999633789062,98.38999938964844,93.95999908447266,96.77999877929688,96477500.0,0.0,0.0,2.30999755859375,0.0,2.30999755859375,77.07124401936676,74.4800033569336,98.38999938964844,93.2664120556579,-6.733587944342107,2.1545039122784573,0.276315731832659,0.1269213073413913,-397128700.0,1.0
396,2022-08-02,AMD,95.70999908447266,100.91999816894533,95.36000061035156,99.29000091552734,116734100.0,0.0,0.0,2.5100021362304688,0.0,2.5100021362304688,80.27100843978229,76.0,100.91999816894533,93.45907956185468,-6.5409204381453145,2.8107875282434236,0.7832100911148153,0.11025383625969765,-280394600.0,1.0
397,2022-08-03,AMD,94.83000183105467,98.7699966430664,93.62000274658205,98.08999633789062,131142000.0,0.0,0.0,-1.2000045776367188,1.2000045776367188,0.0,74.5332251034908,77.9000015258789,100.91999816894533,87.70633256409664,-12.293667435903354,3.197212170904791,1.2660105070728132,0.07684707741159724,-411536600.0,-1.0
398,2022-08-04,AMD,97.5,104.58999633789062,97.26000213623048,103.91000366210938,125855800.0,0.0,0.0,5.82000732421875,0.0,5.82000732421875,81.80961368246129,80.94000244140625,104.58999633789062,97.12476595656825,-2.875234043431751,3.9278001650333607,1.798368438664925,0.1794552265813305,-285680800.0,1.0
399,2022-08-05,AMD,101.0500030517578,103.86000061035156,100.9800033569336,102.30999755859376,93859900.0,0.0,0.0,-1.6000061035156108,1.6000061035156108,0.0,75.0111070736518,82.19000244140625,104.58999633789062,89.82143124755628,-10.178568752443727,4.327802193289514,2.3042551895898447,0.16872282943335692,-379540700.0,-1.0
400,2022-08-08,AMD,100.05999755859376,101.8000030517578,97.98999786376952,100.06999969482422,92606800.0,0.0,0.0,-2.2399978637695455,2.2399978637695455,0.0,66.13334424617753,84.70999908447266,104.58999633789062,77.26359523370013,-22.73640476629987,4.413186623448297,2.7260414763615364,0.1738416386489645,-472147500.0,-1.0
401,2022-08-09,AMD,97.9499969482422,98.0500030517578,93.66999816894533,95.54000091552734,89473700.0,0.0,0.0,-4.529998779296875,4.529998779296875,0.0,51.82173938982372,84.70999908447266,104.58999633789062,54.476877903957885,-45.523122096042115,4.068426043584864,2.9945183898062027,0.06368293520527302,-561621200.0,-1.0
402,2022-08-10,AMD,98.4499969482422,99.3499984741211,95.61000061035156,99.0500030517578,83416100.0,0.0,0.0,3.5100021362304545,0.0,3.5100021362304545,59.63195121304845,84.70999908447266,104.58999633789062,72.13282670257746,-27.867173297422543,4.031948627317448,3.202004437308452,0.08050621828541238,-478205100.0,1.0
403,2022-08-11,AMD,99.93000030517578,102.37000274658205,98.0,98.12000274658205,77516900.0,0.0,0.0,-0.9300003051757528,0.9300003051757528,0.0,56.81611835246083,84.70999908447266,104.58999633789062,67.45475611071228,-32.545243889287725,3.8832337431725676,3.338250298481275,0.03863661986572531,-555722000.0,-1.0
404,2022-08-12,AMD,99.1999969482422,101.4000015258789,98.4800033569336,100.83000183105467,72316300.0,0.0,0.0,2.709999084472628,0.0,2.709999084472628,62.73292197299946,84.70999908447266,104.58999633789062,81.08654413325185,-18.913455866748148,3.93864665213529,3.458329569212078,0.04184752121141977,-483405700.0,1.0
405,2022-08-15,AMD,100.51000213623048,101.8499984741211,99.8000030517578,101.01000213623048,61327100.0,0.0,0.0,0.18000030517580967,0.0,0.18000030517580967,63.12018515915943,86.29000091552734,104.58999633789062,80.43718526134026,-19.562814738659743,3.95153532471285,3.556970720312232,0.017323005386679968,-422078600.0,1.0
406,2022-08-16,AMD,100.83999633789062,101.4499969482422,98.31999969482422,100.1999969482422,60220700.0,0.0,0.0,-0.8100051879882812,0.8100051879882812,0.0,59.88879842928335,88.58999633789062,104.58999633789062,72.56250381469735,-27.437496185302646,3.851986071578551,3.6159737905654956,0.021510864401332652,-482299300.0,-1.0
407,2022-08-17,AMD,99.26000213623048,99.63999938964844,96.7300033569336,98.2699966430664,63735600.0,0.0,0.0,-1.9300003051757955,1.9300003051757955,0.0,52.49964739749037,90.55999755859376,104.58999633789062,54.95366896146688,-45.04633103853312,3.5761350032918813,3.608006033110773,-0.05427780598856424,-546034900.0,-1.0
408,2022-08-18,AMD,97.73999786376952,101.06999969482422,96.7300033569336,100.44000244140624,76059500.0,0.0,0.0,2.1700057983398295,0.0,2.1700057983398295,59.05376645598373,93.62000274658205,104.58999633789062,62.16958686491495,-37.83041313508505,3.4923637115030743,3.584877568789233,-0.01827773591839421,-469975400.0,1.0
409,2022-08-19,AMD,98.66999816894533,99.25,94.58999633789062,95.9499969482422,67221700.0,0.0,0.0,-4.490005493164034,4.490005493164034,0.0,44.42066373948853,93.62000274658205,104.58999633789062,21.23970431036704,-78.76029568963297,3.0287564272781253,3.4736533404870116,-0.04117120774604255,-537197100.0,-1.0
410,2022-08-22,AMD,94.4000015258789,95.0199966430664,92.36000061035156,92.83999633789062,61837300.0,0.0,0.0,-3.1100006103515767,3.1100006103515767,0.0,37.07781670967565,92.36000061035156,104.58999633789062,3.924741579902808,-96.07525842009719,2.382925418047904,3.2555077559991896,-0.02826046212856914,-599034400.0,-1.0
411,2022-08-23,AMD,92.38999938964844,94.44000244140624,92.11000061035156,92.48999786376952,52927000.0,0.0,0.0,-0.34999847412110796,0.34999847412110796,0.0,36.298662109820114,92.11000061035156,104.58999633789062,3.0448508293911605,-96.95514917060883,1.8218566268404857,2.9687775301674493,-0.0662292275201688,-651961400.0,-1.0
412,2022-08-24,AMD,92.20999908447266,93.37999725341795,90.9000015258789,92.7300033569336,56520400.0,0.0,0.0,0.2400054931640767,0.0,0.2400054931640767,37.34049811290565,90.9000015258789,103.86000061035156,14.120385496378688,-85.87961450362131,1.3806565944973386,2.6511533430334273,-0.05493272766786805,-595441000.0,1.0
413,2022-08-25,AMD,93.13999938964844,97.56999969482422,93.13999938964844,97.18000030517578,61016200.0,0.0,0.0,4.4499969482421875,0.0,4.4499969482421875,53.58193027091821,90.9000015258789,102.37000274658205,54.75150924972522,-45.248490750274776,1.37423741840054,2.39577015810685,-0.03619955826237753,-534424800.0,1.0
414,2022-08-26,AMD,96.29000091552734,97.5999984741211,91.12000274658205,91.18000030517578,65552500.0,0.0,0.0,-6.0,6.0,0.0,38.18410356663863,90.9000015258789,102.37000274658205,2.441139925874484,-97.55886007412552,0.874916304478063,2.0915993873810925,-0.09731711338642623,-599977300.0,-1.0
415,2022-08-29,AMD,90.05000305175781,91.19000244140624,88.26000213623047,88.48999786376953,61142500.0,0.0,0.0,-2.69000244140625,2.69000244140625,0.0,33.242339731622295,88.26000213623047,102.37000274658205,1.630019260029867,-98.36998073997013,0.2591532767253426,1.7251101652499425,-0.1168662618874271,-661119800.0,-1.0
416,2022-08-30,AMD,90.05999755859375,90.1500015258789,85.33999633789062,86.94000244140625,69087100.0,0.0,0.0,-1.5499954223632812,1.5499954223632812,0.0,30.608624311233285,85.33999633789062,102.37000274658205,9.395217271903357,-90.60478272809664,-0.3498814759549589,1.3101118370089622,-0.11529454145411899,-730206900.0,-1.0
417,2022-08-31,AMD,86.27999877929688,86.72000122070312,83.72000122070312,84.87000274658203,64991700.0,0.0,0.0,-2.0699996948242188,2.0699996948242188,0.0,27.278328640046894,83.72000122070312,101.8499984741211,6.343087148907878,-93.65691285109212,-0.9881859650769087,0.8504522765917879,-0.1550179143405267,-795198600.0,-1.0
418,2022-09-01,AMD,82.3499984741211,82.76000213623047,78.5199966430664,82.33000183105469,94854700.0,0.0,0.0,-2.5400009155273438,2.5400009155273438,0.0,23.637123807719917,78.5199966430664,101.8499984741211,16.33092537059626,-83.66907462940374,-1.6796413767298333,0.3444335459274635,-0.14194888536092898,-890053300.0,-1.0
419,2022-09-02,AMD,83.31999969482422,83.6500015258789,79.80999755859375,80.23999786376953,84924400.0,0.0,0.0,-2.0900039672851562,2.0900039672851562,0.0,20.978467184398113,78.5199966430664,101.4499969482422,7.501095498524192,-92.4989045014758,-2.3689623291006257,-0.1982456290781545,-0.13571735212336145,-974977700.0,-1.0
420,2022-09-06,AMD,80.41000366210938,80.88999938964844,78.37000274658203,78.72000122070312,68727300.0,0.0,0.0,-1.5199966430664062,1.5199966430664062,0.0,19.169153072703438,78.37000274658203,101.06999969482422,1.541843705614227,-98.45815629438577,-3.003284917846713,-0.7592534868318664,-0.1488809272473821,-1043705000.0,-1.0
421,2022-09-07,AMD,79.23999786376953,80.25,77.73999786376953,79.61000061035156,67891200.0,0.0,0.0,0.8899993896484375,0.0,0.8899993896484375,23.61973078973959,77.73999786376953,101.06999969482422,8.015441919480953,-91.98455808051905,-3.395038838951109,-1.2864105572557152,-0.14148605922164048,-975813800.0,1.0
422,2022-09-08,AMD,80.02999877929688,83.44999694824219,79.23999786376953,82.77999877929688,89089300.0,0.0,0.0,3.1699981689453125,0.0,3.1699981689453125,37.71411507140563,77.73999786376953,99.25,23.430964272375387,-76.56903572762461,-3.4104017026741786,-1.7112087863394079,-0.14817865281599474,-886724500.0,1.0
423,2022-09-09,AMD,84.02999877929688,85.68000030517578,83.83999633789062,85.44999694824219,68907700.0,0.0,0.0,2.6699981689453125,0.0,2.6699981689453125,47.185582622050894,77.73999786376953,97.5999984741211,38.821746462857604,-61.17825353714239,-3.1705821673057386,-2.003083462532674,-0.06284276527479171,-817816800.0,1.0
424,2022-09-12,AMD,84.88999938964844,85.3499984741211,83.45999908447266,84.63999938964844,71922500.0,0.0,0.0,-0.80999755859375,0.80999755859375,0.0,44.80087684482197,77.73999786376953,97.5999984741211,34.74320903234233,-65.25679096765766,-3.0111724716949624,-2.204701264365132,-0.04350772479448095,-889739300.0,-1.0
425,2022-09-13,AMD,80.95999908447266,81.47000122070312,76.80000305175781,77.02999877929688,80921200.0,0.0,0.0,-7.6100006103515625,7.6100006103515625,0.0,28.943639873266164,76.80000305175781,97.5999984741211,1.1057489334434216,-98.89425106655658,-3.459028252471242,-2.4555666619863543,-0.11398669638626113,-970660500.0,-1.0
426,2022-09-14,AMD,77.0999984741211,78.08000183105469,75.87000274658203,77.44999694824219,71483000.0,0.0,0.0,0.4199981689453125,0.0,0.4199981689453125,30.509937594600544,75.87000274658203,97.5999984741211,7.271028588642488,-92.7289714113575,-3.736989185754382,-2.7118511667399603,-0.0874278962909385,-899177500.0,1.0
427,2022-09-15,AMD,76.63999938964844,77.97000122070312,74.91000366210938,76.66000366210938,81818000.0,0.0,0.0,-0.7899932861328125,0.7899932861328125,0.0,29.11696866843451,74.91000366210938,97.5999984741211,7.712650507410333,-92.28734949258967,-3.9751973997968975,-2.964520413351348,-0.06886916121513553,-980995500.0,-1.0
428,2022-09-16,AMD,75.62000274658203,76.81999969482422,74.68000030517578,76.51000213623047,75300200.0,0.0,0.0,-0.15000152587890625,0.15000152587890625,0.0,28.828602779128033,74.68000030517578,91.19000244140624,11.084201055545783,-88.91579894445421,-4.128492283012548,-3.1973147872835885,-0.046485491361450415,-1056295700.0,-1.0
429,2022-09-19,AMD,75.38999938964844,77.33999633789062,75.3499984741211,76.7699966430664,64966900.0,0.0,0.0,0.2599945068359375,0.0,0.2599945068359375,30.21090091257024,74.68000030517578,90.1500015258789,13.50999465399934,-86.49000534600066,-4.18080647520722,-3.394013124868316,-0.02477139923016003,-991328800.0,1.0
430,2022-09-20,AMD,76.08000183105469,76.58000183105469,74.7300033569336,75.25,51129100.0,0.0,0.0,-1.5199966430664062,1.5199966430664062,0.0,26.711306434575647,74.68000030517578,86.72000122070312,4.7342163744283505,-95.26578362557166,-4.2954020372733765,-3.5742909073493276,-0.05476699631860871,-1042457900.0,-1.0
431,2022-09-21,AMD,75.44000244140625,78.41000366210938,74.44999694824219,74.4800033569336,82069700.0,0.0,0.0,-0.7699966430664062,0.7699966430664062,0.0,25.01739667357559,74.44999694824219,85.68000030517578,0.26719857276694214,-99.73280142723306,-4.397658609663466,-3.738964447812155,-0.10026571085718705,-1124527600.0,-1.0
432,2022-09-22,AMD,73.88999938964844,74.29000091552734,69.16999816894531,69.5,101436900.0,0.0,0.0,-4.980003356933594,4.980003356933594,0.0,16.981179005102973,69.16999816894531,85.68000030517578,1.998799444916564,-98.00120055508343,-4.824923303556986,-3.9561562189611217,-0.18665883578560272,-1225964500.0,-1.0
433,2022-09-23,AMD,68.0,69.08000183105469,66.81999969482422,67.95999908447266,87690000.0,0.0,0.0,-1.5400009155273438,1.5400009155273438,0.0,15.234990897611581,66.81999969482422,85.68000030517578,6.044535274419522,-93.95546472558047,-5.227538942594919,-4.210432763687882,-0.19706994831589952,-1313654500.0,-1.0
434,2022-09-26,AMD,67.87000274658203,68.73999786376953,66.25,66.30000305175781,82898700.0,0.0,0.0,-1.6599960327148438,1.6599960327148438,0.0,13.507442259231112,66.25,85.68000030517578,0.2573497219374343,-99.74265027806256,-5.615826692260896,-4.491511549402484,-0.13929632477708065,-1396553200.0,-1.0
435,2022-09-27,AMD,67.9000015258789,68.77999877929688,66.0,67.16999816894531,94871800.0,0.0,0.0,0.8699951171875,0.0,0.8699951171875,19.057797425277172,66.0,85.68000030517578,5.945112554889578,-94.05488744511042,-5.7866414297492526,-4.750537525471838,-0.13273078352949108,-1301681400.0,1.0
436,2022-09-28,AMD,67.11000061035156,68.80000305175781,66.55999755859375,68.36000061035156,72389500.0,0.0,0.0,1.19000244140625,0.0,1.19000244140625,26.50166251926123,66.0,85.68000030517578,11.991872834122312,-88.0081271658777,-5.759597085129059,-4.952349437403282,-0.10827031900939288,-1229291900.0,1.0
437,2022-09-29,AMD,67.1500015258789,67.19999694824219,62.83000183105469,64.13999938964844,102552400.0,0.0,0.0,-4.220001220703125,4.220001220703125,0.0,19.255708068323656,62.83000183105469,85.3499984741211,5.817041535825806,-94.18295846417419,-6.009410154909162,-5.163761580904459,-0.16167824338256487,-1331844300.0,-1.0
438,2022-09-30,AMD,63.619998931884766,65.91000366210938,63.34000015258789,63.36000061035156,81664100.0,0.0,0.0,-0.779998779296875,0.779998779296875,0.0,18.194750908506066,62.83000183105469,81.47000122070312,2.843341183751354,-97.15665881624864,-6.198871427015334,-5.370783550126634,-0.17467756440140458,-1413508400.0,-1.0
439,2022-10-03,AMD,64.45999908447266,66.91000366210938,63.38999938964844,66.11000061035156,83841600.0,0.0,0.0,2.75,0.0,2.75,33.173449349407875,62.83000183105469,78.41000366210938,21.052621269652544,-78.94737873034745,-6.057294208952527,-5.508085681891814,-0.1214617859089493,-1329666800.0,1.0
440,2022-10-04,AMD,68.2699966430664,69.18000030517578,67.33000183105469,67.9000015258789,77160500.0,0.0,0.0,1.7900009155273438,0.0,1.7900009155273438,41.25234351434641,62.83000183105469,78.41000366210938,32.541714370780696,-67.4582856292193,-5.734550852541574,-5.553378716021766,-0.08834588526427789,-1252506300.0,1.0
441,2022-10-05,AMD,66.58999633789062,68.69000244140625,64.5199966430664,67.94000244140625,87127400.0,0.0,0.0,0.04000091552734375,0.0,0.04000091552734375,41.43490380558002,62.83000183105469,78.41000366210938,32.79845962640456,-67.20154037359545,-5.413147283826319,-5.525332429582677,-0.02244600803732011,-1165378900.0,1.0
442,2022-10-06,AMD,67.81999969482422,70.29000091552734,67.66000366210938,67.8499984741211,98325900.0,0.0,0.0,-0.09000396728515625,0.09000396728515625,0.0,41.10329046646182,62.83000183105469,78.41000366210938,32.22077055896327,-67.77922944103673,-5.10682688158208,-5.441631319982558,-0.0016186081788323037,-1263704800.0,-1.0
443,2022-10-07,AMD,64.01000213623047,64.02999877929688,58.220001220703125,58.43999862670898,163786300.0,0.0,0.0,-9.409999847412116,9.409999847412116,0.0,20.912638163617274,58.220001220703125,78.41000366210938,1.0896353610868075,-98.9103646389132,-5.5592898166190565,-5.465163019309858,-0.11855209748501572,-1427491100.0,-1.0
444,2022-10-10,AMD,57.310001373291016,58.790000915527344,56.29999923706055,57.810001373291016,112241800.0,0.0,0.0,-0.6299972534179616,0.6299972534179616,0.0,20.14809044271739,56.29999923706055,78.41000366210938,6.829497214029319,-93.17050278597068,-5.900686010334752,-5.552267617514837,-0.1393478792736026,-1539732900.0,-1.0
445,2022-10-11,AMD,57.209999084472656,58.91999816894531,56.04999923706055,57.630001068115234,114054800.0,0.0,0.0,-0.18000030517578125,0.18000030517578125,0.0,19.90814687994478,56.04999923706055,74.29000091552734,8.662289943317033,-91.33771005668297,-6.115276366242782,-5.664869367260427,-0.1569631282392282,-1653787700.0,-1.0
446,2022-10-12,AMD,57.45000076293945,58.31999969482422,56.31999969482422,57.84999847412109,89264200.0,0.0,0.0,0.21999740600585227,0.0,0.21999740600585227,21.231033380760834,56.04999923706055,70.29000091552734,12.64044259055413,-87.35955740944587,-6.196163304725218,-5.771128154753386,-0.09806674423733308,-1564523500.0,1.0
447,2022-10-13,AMD,55.52000045776367,60.13999938964844,54.56999969482422,58.93999862670898,131159800.0,0.0,0.0,1.0900001525878906,0.0,1.0900001525878906,28.02713606865582,54.56999969482422,70.29000091552734,27.798973234998876,-72.20102676500112,-6.1019731535053054,-5.837297154503771,-0.06976013164558681,-1433363700.0,1.0
448,2022-10-14,AMD,59.59999847412109,59.93999862670898,55.84000015258789,55.93999862670898,96959300.0,0.0,0.0,-3.0,3.0,0.0,21.999356472084344,54.56999969482422,70.29000091552734,8.715005251274919,-91.28499474872508,-6.197955478815253,-5.9094288193660685,-0.1538345468121226,-1530323000.0,-1.0
449,2022-10-17,AMD,57.34999847412109,58.5099983215332,57.09999847412109,57.959999084472656,76977600.0,0.0,0.0,2.020000457763679,0.0,2.020000457763679,33.166695409159786,54.56999969482422,70.29000091552734,21.564879938964847,-78.43512006103515,-6.041383728217582,-5.935819801136372,-0.14639178524344787,-1453345400.0,1.0
450,2022-10-18,AMD,59.90999984741211,60.4900016784668,56.400001525878906,57.91999816894531,103064500.0,0.0,0.0,-0.04000091552734375,0.04000091552734375,0.0,33.05855158977971,54.56999969482422,70.29000091552734,21.310421208550355,-78.68957879144965,-5.853056829198138,-5.919267206748726,-0.14748313088599796,-1556409900.0,-1.0
451,2022-10-19,AMD,57.33000183105469,59.040000915527344,56.56999969482422,57.22999954223633,75704800.0,0.0,0.0,-0.6899986267089844,0.6899986267089844,0.0,31.04389116566378,54.56999969482422,70.29000091552734,16.921117308241104,-83.07888269175889,-5.69384837623403,-5.874183440645788,-0.1565217269081498,-1632114700.0,-1.0
452,2022-10-20,AMD,57.470001220703125,60.20000076293945,57.400001525878906,57.77000045776367,79552600.0,0.0,0.0,0.5400009155273438,0.0,0.5400009155273438,34.64071763158451,54.56999969482422,70.29000091552734,20.356237369276258,-79.64376263072374,-5.461148257332681,-5.791576403983167,-0.01146471910831115,-1552562100.0,1.0
453,2022-10-21,AMD,57.220001220703125,58.90999984741211,55.709999084472656,58.81999969482422,95366400.0,0.0,0.0,1.0499992370605469,0.0,1.0499992370605469,41.488223553903474,54.56999969482422,70.29000091552734,27.03562131027561,-72.96437868972438,-5.132837430262008,-5.659828609238936,0.01747099632486493,-1457195700.0,1.0
454,2022-10-24,AMD,58.56999969482422,59.0,56.65999984741211,58.70000076293945,76305400.0,0.0,0.0,-0.11999893188476562,0.11999893188476562,0.0,40.922860494782405,54.56999969482422,70.29000091552734,26.272269385552292,-73.72773061444771,-4.826692536094626,-5.493201394610074,0.018566713083339126,-1533501100.0,-1.0
455,2022-10-25,AMD,58.77000045776367,61.97999954223633,58.68999862670898,61.470001220703125,85501900.0,0.0,0.0,2.770000457763672,0.0,2.770000457763672,56.65511094416364,54.56999969482422,70.29000091552734,43.893136069173174,-56.10686393082683,-4.310861712743794,-5.256733458236819,0.06257567574874567,-1447999200.0,1.0
456,2022-10-26,AMD,59.68999862670898,61.77000045776367,59.150001525878906,59.72999954223633,79761600.0,0.0,0.0,-1.7400016784667969,1.7400016784667969,0.0,47.48905234950722,54.56999969482422,64.02999877929688,54.54545821131812,-45.45454178868188,-3.996397660654935,-5.004666298720442,0.013403476992436714,-1527760800.0,-1.0
457,2022-10-27,AMD,61.59999847412109,62.720001220703125,58.5099983215332,58.59999847412109,83871400.0,0.0,0.0,-1.1300010681152415,1.1300010681152415,0.0,42.35431439884329,54.56999969482422,62.720001220703125,49.44782852494335,-50.55217147505665,-3.7946222225691812,-4.762657483490191,0.04755094588332853,-1611632200.0,-1.0
458,2022-10-28,AMD,59.09999847412109,62.34999847412109,58.91999816894531,62.0099983215332,78198600.0,0.0,0.0,3.4099998474121165,0.0,3.4099998474121165,58.121107841706355,54.56999969482422,62.720001220703125,91.28830961668618,-8.711690383313815,-3.3212697428709532,-4.474379935366343,0.06987576433805587,-1533433600.0,1.0
459,2022-10-31,AMD,60.75,61.86000061035156,59.52999877929688,60.060001373291016,73274100.0,0.0,0.0,-1.9499969482421875,1.9499969482421875,0.0,49.235582175662245,54.56999969482422,62.720001220703125,67.36197117306365,-32.63802882693634,-3.0681156071900304,-4.193127069731081,0.03694757030384532,-1606707700.0,-1.0
460,2022-11-01,AMD,61.4900016784668,61.9900016784668,59.43000030517578,59.65999984741211,83806700.0,0.0,0.0,-0.40000152587890625,0.40000152587890625,0.0,47.516222364957954,54.56999969482422,62.720001220703125,62.45397790939651,-37.546022090603486,-2.8667201424918005,-3.927845684283225,0.04246025379368423,-1690514400.0,-1.0
461,2022-11-02,AMD,63.0,63.93000030517578,58.56999969482422,58.630001068115234,142669400.0,0.0,0.0,-1.029998779296875,1.029998779296875,0.0,43.04959490641545,55.709999084472656,63.93000030517578,35.523133211807554,-64.47686678819244,-2.7584276353418105,-3.693962074494942,0.014886629799844231,-1833183800.0,-1.0
462,2022-11-03,AMD,58.11000061035156,62.27999877929688,58.02999877929688,60.11000061035156,95279900.0,0.0,0.0,1.4799995422363281,0.0,1.4799995422363281,50.72860841395891,55.709999084472656,63.93000030517578,53.52799114916114,-46.47200885083886,-2.524085372835131,-3.45998673416298,0.021931331557637712,-1737903900.0,1.0
463,2022-11-04,AMD,62.5,63.0,60.52999877929688,62.18999862670898,84791300.0,0.0,0.0,2.0799980163574148,0.0,2.0799980163574148,59.56901404625478,55.709999084472656,63.93000030517578,78.8320995125355,-21.167900487464493,-2.1457936233019197,-3.197148111990768,0.05945481803081942,-1653112600.0,1.0
464,2022-11-07,AMD,62.93000030517578,63.52999877929688,61.400001525878906,63.08000183105469,62722500.0,0.0,0.0,0.8900032043457102,0.0,0.8900032043457102,62.859093735148186,55.709999084472656,63.93000030517578,89.65938749522002,-10.340612504779973,-1.7539603078854142,-2.9085105511696976,0.026191647606626622,-1590390100.0,1.0
465,2022-11-08,AMD,64.08999633789062,64.95999908447266,62.369998931884766,63.84999847412109,75938000.0,0.0,0.0,0.7699966430663991,0.0,0.7699966430663991,65.64951710130225,55.709999084472656,64.95999908447266,87.99999340160466,-12.000006598395348,-1.365556012566671,-2.5999196434490925,0.06897704609844202,-1514452100.0,1.0
466,2022-11-09,AMD,62.27999877929688,63.04999923706055,59.79999923706055,59.91999816894531,62940300.0,0.0,0.0,-3.930000305175774,3.930000305175774,0.0,45.5123452101064,55.709999084472656,64.95999908447266,45.513503615920605,-54.486496384079395,-1.359193041474228,-2.3517743230541197,0.02252559264838827,-1577392400.0,-1.0
467,2022-11-10,AMD,64.30000305175781,68.80000305175781,63.619998931884766,68.47000122070312,107996300.0,0.0,0.0,8.550003051757812,0.0,8.550003051757812,69.21594666747897,56.65999984741211,68.80000305175781,97.28169897898744,-2.718301021012566,-0.6566669380718011,-2.012752846057656,0.10417679525926804,-1469396100.0,1.0
468,2022-11-11,AMD,69.58000183105469,73.31999969482422,68.29000091552734,72.37000274658203,111709500.0,0.0,0.0,3.9000015258789062,0.0,3.9000015258789062,74.95116726801288,58.02999877929688,73.31999969482422,93.78680908202271,-6.213190917977281,0.21233985272061773,-1.567734306302001,0.2049617231405083,-1357686600.0,1.0
469,2022-11-14,AMD,75.22000122070312,75.25,72.66999816894531,73.52999877929688,108892800.0,0.0,0.0,1.1599960327148438,0.0,1.1599960327148438,76.45650807688607,58.02999877929688,75.25,90.01160802105393,-9.988391978946067,0.9833010931310326,-1.0575272264153943,0.23248405912435488,-1248793800.0,1.0
470,2022-11-15,AMD,77.26000213623047,79.16000366210938,75.38999938964844,76.37000274658203,108946300.0,0.0,0.0,2.8400039672851562,0.0,2.8400039672851562,79.8733789169543,58.02999877929688,79.16000366210938,86.79602332796061,-13.20397667203938,1.8026778578322649,-0.4854862095658623,0.30257549642301385,-1139847500.0,1.0
471,2022-11-16,AMD,73.66000366210938,74.83000183105469,71.93000030517578,72.69999694824219,79968000.0,0.0,0.0,-3.6700057983398438,3.6700057983398438,0.0,65.66384842734027,58.02999877929688,79.16000366210938,69.4273297630808,-30.57267023691919,2.1313323885115665,0.0378775100496236,0.20944927982120998,-1219815500.0,-1.0
472,2022-11-17,AMD,70.55999755859375,74.37999725341797,70.16000366210938,73.9000015258789,82320800.0,0.0,0.0,1.2000045776367188,0.0,1.2000045776367188,67.82348528553166,58.02999877929688,79.16000366210938,75.10647931506611,-24.89352068493389,2.4602634234970537,0.5223546927391098,0.1882939887080297,-1137494700.0,1.0
473,2022-11-18,AMD,75.06999969482422,75.3499984741211,72.18000030517578,73.56999969482422,73223200.0,0.0,0.0,-0.3300018310546875,0.3300018310546875,0.0,66.4963707376111,58.02999877929688,79.16000366210938,73.54471048025096,-26.455289519749055,2.6636108020396563,0.9506059145992193,0.1662967273188194,-1210717900.0,-1.0
474,2022-11-21,AMD,72.20999908447266,72.9800033569336,71.56999969482422,72.45999908447266,51536300.0,0.0,0.0,-1.1100006103515625,1.1100006103515625,0.0,61.80292188720172,58.02999877929688,79.16000366210938,68.29151429545283,-31.708485704547172,2.704026954937362,1.301290122666848,0.1348473111372317,-1262254200.0,-1.0
475,2022-11-22,AMD,72.72000122070312,75.33000183105469,72.11000061035156,75.25,55450200.0,0.0,0.0,2.7900009155273438,0.0,2.7900009155273438,68.29335242944009,58.02999877929688,79.16000366210938,81.49549096749222,-18.50450903250779,2.927441079209345,1.6265203139753477,0.2558411598717263,-1206804000.0,1.0
476,2022-11-23,AMD,75.48999786376953,78.22000122070312,75.30000305175781,76.4000015258789,81623600.0,0.0,0.0,1.1500015258789062,0.0,1.1500015258789062,70.66409719057484,59.79999923706055,79.16000366210938,85.74379387713643,-14.256206122863569,3.160857494243004,1.9333877500288792,0.11581714858766512,-1125180400.0,1.0
477,2022-11-25,AMD,75.66999816894531,76.04000091552734,74.75,75.13999938964844,26018900.0,0.0,0.0,-1.2600021362304688,1.2600021362304688,0.0,64.56131829673492,59.79999923706055,79.16000366210938,79.2355198676521,-20.764480132347895,3.2071994461538367,2.1881500892538712,0.038275480695587394,-1151199300.0,-1.0
478,2022-11-28,AMD,73.80999755859375,75.47000122070312,72.56999969482422,73.19000244140625,45383800.0,0.0,0.0,-1.9499969482421875,1.9499969482421875,0.0,55.935042309595026,59.79999923706055,79.16000366210938,69.16322388346732,-30.836776116532672,3.051402653003791,2.3608006020038554,-0.0046239132807703864,-1196583100.0,-1.0
479,2022-11-29,AMD,73.62000274658203,74.48999786376953,72.77999877929688,73.38999938964844,51846400.0,0.0,0.0,0.1999969482421875,0.0,0.1999969482421875,56.62095414717642,59.79999923706055,79.16000366210938,70.19626573537633,-29.803734264623678,2.910519991116857,2.4707444798264557,-0.03902060036349764,-1144736700.0,1.0
480,2022-11-30,AMD,73.37999725341797,77.69999694824219,72.80999755859375,77.62999725341797,88468400.0,0.0,0.0,4.239997863769531,0.0,4.239997863769531,68.58348605701568,63.619998931884766,79.16000366210938,90.15440191137387,-9.845598088626142,3.105206959526015,2.5976369757663678,0.06781293689304602,-1056268300.0,1.0
481,2022-12-01,AMD,78.30999755859375,79.2300033569336,76.44000244140625,77.4800033569336,59833400.0,0.0,0.0,-0.149993896484375,0.149993896484375,0.0,67.82007710315453,68.29000091552734,79.2300033569336,84.00365987692548,-15.996340123074521,3.2103871857337367,2.7201870177598417,0.04844386680832491,-1116101700.0,-1.0
482,2022-12-02,AMD,75.05000305175781,76.27999877929688,73.6500015258789,74.9800033569336,64377200.0,0.0,0.0,-2.5,2.5,0.0,55.86183778374153,70.16000366210938,79.2300033569336,53.142225545770906,-46.8577744542291,3.056777540629014,2.7875051223336764,0.019165470544491026,-1180478900.0,-1.0
483,2022-12-05,AMD,74.54000091552734,75.16999816894531,72.81999969482422,73.62000274658203,47022200.0,0.0,0.0,-1.3600006103515625,1.3600006103515625,0.0,50.29532071978873,70.16000366210938,79.2300033569336,38.147730991072685,-61.852269008927315,2.7931029562941774,2.788624689125777,0.016008883201296564,-1227501100.0,-1.0
484,2022-12-06,AMD,73.08000183105469,73.38999938964844,69.4000015258789,70.2699966430664,64965200.0,0.0,0.0,-3.350006103515625,3.350006103515625,0.0,39.194644074836674,69.4000015258789,79.2300033569336,8.850406461156842,-91.14959353884315,2.2874531212139146,2.688390375543405,-0.06617944660376873,-1292466300.0,-1.0
485,2022-12-07,AMD,69.52999877929688,71.37000274658203,69.27999877929688,70.13999938964844,59180100.0,0.0,0.0,-0.12999725341796875,0.12999725341796875,0.0,38.81110084891334,69.27999877929688,79.2300033569336,8.643218238155082,-91.35678176184491,1.8548507275494899,2.521682445944622,-0.08193719909953179,-1351646400.0,-1.0
486,2022-12-08,AMD,70.13999938964844,71.22000122070312,69.0,70.47000122070312,56734100.0,0.0,0.0,0.3300018310546875,0.0,0.3300018310546875,40.516073052644806,69.0,79.2300033569336,14.369508683560712,-85.63049131643929,1.521104260297875,2.3215668088152728,-0.06215062825231632,-1294912300.0,1.0
487,2022-12-09,AMD,69.48999786376953,70.66999816894531,68.5199966430664,68.58999633789062,59058300.0,0.0,0.0,-1.8800048828125,1.8800048828125,0.0,34.243895295432765,68.5199966430664,79.2300033569336,0.6535915120723873,-99.34640848792762,1.092315566092438,2.0757165602707057,-0.06285019743233722,-1353970600.0,-1.0
488,2022-12-12,AMD,68.54000091552734,70.66999816894531,67.52999877929688,70.66999816894531,60968300.0,0.0,0.0,2.0800018310546875,0.0,2.0800018310546875,45.09461615862065,67.52999877929688,79.2300033569336,26.837591120692412,-73.16240887930759,0.9098480376227087,1.8425428557411063,-0.03706228700537062,-1293002300.0,1.0
489,2022-12-13,AMD,74.87000274658203,75.20999908447266,70.66000366210938,71.6500015258789,72458000.0,0.0,0.0,0.9800033569335938,0.0,0.9800033569335938,49.61462000196675,67.52999877929688,79.2300033569336,35.213684911345815,-64.78631508865418,0.8346974144127017,1.6409737674754252,-0.0770320229178646,-1220544300.0,1.0
490,2022-12-14,AMD,70.93000030517578,72.0,68.31999969482422,68.93000030517578,67278000.0,0.0,0.0,-2.720001220703125,2.720001220703125,0.0,39.263217418989235,67.52999877929688,79.2300033569336,11.965820325872832,-88.03417967412716,0.549326347319294,1.422644283444199,-0.11035109294419876,-1287822300.0,-1.0
491,2022-12-15,AMD,67.5999984741211,68.20999908447266,66.12000274658203,66.52999877929688,58557000.0,0.0,0.0,-2.4000015258789062,2.4000015258789062,0.0,32.38437480863877,66.12000274658203,79.2300033569336,3.127353269466012,-96.87264673053399,0.1280317860386333,1.163721783963086,-0.1126967751309833,-1346379300.0,-1.0
492,2022-12-16,AMD,66.25,67.19000244140625,64.80000305175781,65.41000366210938,62438600.0,0.0,0.0,-1.1199951171875,1.1199951171875,0.0,29.592689603660745,64.80000305175781,79.2300033569336,4.227308367642697,-95.7726916323573,-0.29284569125277926,0.872408288919913,-0.11151859247728457,-1408817900.0,-1.0
493,2022-12-19,AMD,65.12000274658203,65.58999633789062,63.709999084472656,64.58999633789062,46246900.0,0.0,0.0,-0.82000732421875,0.82000732421875,0.0,27.583892867767943,63.709999084472656,79.2300033569336,5.6700838348315195,-94.32991616516848,-0.6846694188748046,0.5609927473609694,-0.08083108832389896,-1455064800.0,-1.0
494,2022-12-20,AMD,63.7599983215332,66.05999755859375,63.52000045776367,65.05000305175781,52431300.0,0.0,0.0,0.4600067138671875,0.0,0.4600067138671875,30.63183089701141,63.52000045776367,79.2300033569336,9.739034447122744,-90.26096555287725,-0.9471556282875468,0.25936307223126603,-0.07256909583951077,-1402633500.0,1.0
495,2022-12-21,AMD,65.43000030517578,67.8499984741211,65.20999908447266,67.68000030517578,44167600.0,0.0,0.0,2.6299972534179688,0.0,2.6299972534179688,45.70677277683209,63.52000045776367,76.27999877929688,32.60188397040679,-67.3981160295932,-0.9322130710595644,0.021047843573099863,-0.039591327759303074,-1358465900.0,1.0
496,2022-12-22,AMD,66.08000183105469,66.30999755859375,62.2599983215332,63.86000061035156,73917700.0,0.0,0.0,-3.8199996948242188,3.8199996948242188,0.0,33.504216466203744,62.2599983215332,75.20999908447266,12.355229301586414,-87.6447706984136,-1.2146117472267548,-0.22608407458687116,-0.06896043125936291,-1432383600.0,-1.0
497,2022-12-23,AMD,63.11000061035156,64.66000366210938,62.720001220703125,64.5199966430664,45923000.0,0.0,0.0,0.6599960327148438,0.0,0.6599960327148438,36.864454939728546,62.2599983215332,75.20999908447266,17.4517234624488,-82.5482765375512,-1.3693732860500916,-0.4547419168795153,-0.0870242208182399,-1386460600.0,1.0
498,2022-12-27,AMD,63.869998931884766,64.27999877929688,62.970001220703125,63.27000045776367,36086000.0,0.0,0.0,-1.2499961853027344,1.2499961853027344,0.0,33.1983281916403,62.2599983215332,75.20999908447266,7.799243835729425,-92.20075616427059,-1.5747346052716154,-0.6787404545579354,-0.11695744437756228,-1422546600.0,-1.0
499,2022-12-28,AMD,62.540000915527344,63.540000915527344,61.959999084472656,62.56999969482422,39526500.0,0.0,0.0,-0.7000007629394531,0.7000007629394531,0.0,31.193828164181227,61.959999084472656,75.20999908447266,4.603778191332547,-95.39622180866745,-1.7735250486697112,-0.8976973733802907,-0.09226752621781154,-1462073100.0,-1.0
500,2022-12-29,AMD,63.63999938964844,65.18000030517578,63.060001373291016,64.81999969482422,41428500.0,0.0,0.0,2.25,0.0,2.25,43.78281688929452,61.959999084472656,75.20999908447266,21.584910266804243,-78.41508973319576,-1.7295742566181787,-1.0640727500278684,-0.025702677226033255,-1420644600.0,1.0
501,2022-12-30,AMD,63.77000045776367,64.81999969482422,63.13999938964844,64.7699966430664,37127000.0,0.0,0.0,-0.0500030517578125,0.0500030517578125,0.0,43.57836258580627,61.959999084472656,75.20999908447266,21.207528744103772,-78.79247125589622,-1.6794184748506353,-1.1871418949924217,-0.009784543391085476,-1457771600.0,-1.0
13,2022-01-21,GOOG,133.01199340820312,134.760498046875,130.00100708007812,130.0919952392578,41920000.0,0.0,0.0,-3.4145050048828125,3.4145050048828125,0.0,16.024628649136133,130.00100708007812,146.61000061035156,0.547824640992497,-99.4521753590075,-1.0412101829899996,-0.5263853688904884,-0.050454591168659024,-154556000.0,-1.0
14,2022-01-24,GOOG,126.02749633789062,130.77850341796875,124.64195251464844,130.3719940185547,55148000.0,0.0,0.0,0.279998779296875,0.0,0.279998779296875,18.054115298888206,124.64195251464844,146.61000061035156,26.083525850560324,-73.91647414943967,-1.284291603644789,-0.6779666158413485,-0.05918867034898967,-99408000.0,1.0
15,2022-01-25,GOOG,128.4355010986328,129.3385009765625,126.37799835205078,126.7354965209961,36008000.0,0.0,0.0,-3.6364974975585938,3.6364974975585938,0.0,13.253962475571697,124.64195251464844,144.29800415039062,10.650887803635985,-89.34911219636402,-1.673150508993956,-0.87700339447187,-0.09485960780877722,-135416000.0,-1.0
16,2022-01-26,GOOG,130.59249877929688,132.8074951171875,127.15350341796876,129.24000549316406,39630000.0,0.0,0.0,2.5045089721679688,0.0,2.5045089721679688,28.385038719508643,124.64195251464844,143.1855010986328,24.795971265644674,-75.20402873435533,-1.7939555552240734,-1.0603938266223107,-0.08759735358330234,-95786000.0,1.0
17,2022-01-27,GOOG,131.36099243164062,132.60995483398438,128.94500732421875,129.12100219726562,30248000.0,0.0,0.0,-0.1190032958984375,0.1190032958984375,0.0,28.116157514252905,124.64195251464844,143.1855010986328,24.154220872727873,-75.84577912727212,-1.87195284425664,-1.2227056301491768,-0.07194654493940567,-126034000.0,-1.0
18,2022-01-28,GOOG,130.0,133.37049865722656,128.6945037841797,133.2895050048828,30518000.0,0.0,0.0,4.1685028076171875,0.0,4.1685028076171875,48.017989091529,124.64195251464844,143.1855010986328,46.6337521702996,-53.3662478297004,-1.641721043829051,-1.3065087128851518,-0.046477979375285416,-95516000.0,1.0
19,2022-01-31,GOOG,134.197998046875,135.843505859375,132.2740020751953,135.69850158691406,34056000.0,0.0,0.0,2.40899658203125,0.0,2.40899658203125,56.1190480908466,124.64195251464844,143.1855010986328,59.624774741415486,-40.375225258584514,-1.2874305712252578,-1.302693084553173,-0.004343628154887869,-61460000.0,1.0
20,2022-02-01,GOOG,137.8350067138672,138.1999969482422,134.56825256347656,137.8784942626953,51204000.0,0.0,0.0,2.17999267578125,0.0,2.17999267578125,62.260263611036905,124.64195251464844,143.1855010986328,71.38084540883919,-28.61915459116081,-0.8540389503140204,-1.2129622577053425,0.016413333994744095,-10256000.0,1.0
21,2022-02-02,GOOG,151.86349487304688,152.10000610351562,145.5574951171875,148.0364990234375,89750000.0,0.0,0.0,10.158004760742188,0.0,10.158004760742188,78.4646271575974,124.64195251464844,152.10000610351562,85.20103740446604,-14.79896259553396,0.1730348319792938,-0.9357628397684152,0.10883364295166276,79494000.0,1.0
22,2022-02-03,GOOG,145.2949981689453,149.11770629882812,142.2050018310547,142.65049743652344,56930000.0,0.0,0.0,-5.3860015869140625,5.3860015869140625,0.0,62.14098039248829,124.64195251464844,152.10000610351562,65.58565727753015,-34.414342722469854,0.6016137520680047,-0.6282875214011312,0.0965355491255917,22564000.0,-1.0
23,2022-02-04,GOOG,143.01699829101562,144.53524780273438,139.8175048828125,143.01600646972656,49224000.0,0.0,0.0,0.365509033203125,0.0,0.365509033203125,62.74782081278097,124.64195251464844,152.10000610351562,66.91681147613409,-33.083188523865914,0.9525081558027182,-0.31212838596036124,0.0969841149271089,71788000.0,1.0
24,2022-02-07,GOOG,143.70899963378906,143.84649658203125,138.69900512695312,138.93800354003906,44610000.0,0.0,0.0,-4.0780029296875,4.0780029296875,0.0,52.014647904900876,124.64195251464844,152.10000610351562,52.06505617421815,-47.93494382578184,0.9307324064382954,-0.06355622748062986,0.09628326202218651,27178000.0,-1.0
25,2022-02-08,GOOG,138.9912567138672,139.83709716796875,136.8730010986328,139.21299743652344,34256000.0,0.0,0.0,0.274993896484375,0.0,0.274993896484375,52.644907685131855,124.64195251464844,152.10000610351562,53.06656159991909,-46.93343840008091,0.922182751558779,0.133591568327252,0.07716644629736469,61434000.0,1.0
26,2022-02-09,GOOG,140.84974670410156,142.17550659179688,140.3769989013672,141.4530029296875,28628000.0,0.0,0.0,2.2400054931640625,0.0,2.2400054931640625,57.84844255419129,124.64195251464844,152.10000610351562,61.22447958895043,-38.77552041104957,1.0635217460360877,0.31957760386901923,0.09550731889132624,90062000.0,1.0
27,2022-02-10,GOOG,139.5,141.43099975585938,138.0500030517578,138.6024932861328,33018000.0,0.0,0.0,-2.8505096435546875,2.8505096435546875,0.0,49.81162946077293,124.64195251464844,152.10000610351562,50.84315509218996,-49.15684490781004,0.9575074966676311,0.44716358242874166,0.03986051475737251,57044000.0,-1.0
28,2022-02-11,GOOG,138.75,139.2832489013672,133.2884979248047,134.1300048828125,38808000.0,0.0,0.0,-4.4724884033203125,4.4724884033203125,0.0,39.80101086495183,126.37799835205078,152.10000610351562,30.137641686700174,-69.86235831329982,0.5412502346921428,0.4659809128814219,-0.011558688458302213,18236000.0,-1.0
29,2022-02-14,GOOG,133.36549377441406,136.16650390625,133.302001953125,135.3000030517578,26792000.0,0.0,0.0,1.1699981689453125,0.0,1.1699981689453125,43.24392645127608,127.15350341796876,152.10000610351562,32.65587860742038,-67.34412139257961,0.29498902052398535,0.43178253440993464,-0.018701184870968945,45028000.0,1.0
30,2022-02-15,GOOG,137.47149658203125,137.89999389648438,135.5395050048828,136.42550659179688,26578000.0,0.0,0.0,1.1255035400390625,0.0,1.1255035400390625,46.631815618718115,128.6945037841797,152.10000610351562,33.030706635295715,-66.96929336470428,0.18155018930352185,0.38173606538865207,-0.07843330873288445,71606000.0,1.0
31,2022-02-16,GOOG,136.4304962158203,137.9459991455078,134.8236541748047,137.4875030517578,25610000.0,0.0,0.0,1.0619964599609375,0.0,1.0619964599609375,49.88851896452226,128.6945037841797,152.10000610351562,37.56808611757067,-62.431913882429335,0.16898906431572414,0.33918666517406654,-0.036193314972932766,97216000.0,1.0
32,2022-02-17,GOOG,136.14999389648438,136.83949279785156,132.20199584960938,132.30850219726562,30968000.0,0.0,0.0,-5.1790008544921875,5.1790008544921875,0.0,37.13674888462808,132.20199584960938,152.10000610351562,0.5352612964672755,-99.46473870353273,-0.2262925177643922,0.22609082858637478,-0.07486927188620307,66248000.0,-1.0
33,2022-02-18,GOOG,133.03750610351562,133.82400512695312,130.3070526123047,130.46749877929688,31858000.0,0.0,0.0,-1.84100341796875,1.84100341796875,0.0,33.612789186885934,130.3070526123047,152.10000610351562,0.7362295663912428,-99.26377043360876,-0.6698162058186199,0.04690942170537579,-0.06096607511926111,34390000.0,-1.0
34,2022-02-22,GOOG,129.98500061035156,131.9007568359375,127.74099731445312,129.40249633789062,38906000.0,0.0,0.0,-1.06500244140625,1.06500244140625,0.0,31.610606092110174,127.74099731445312,152.10000610351562,6.820881086850848,-93.17911891314915,-1.0886625084085324,-0.18020496431740593,-0.07047115771719581,-4516000.0,-1.0
35,2022-02-23,GOOG,131.07850646972656,131.74899291992188,127.50350189208984,127.58499908447266,26432000.0,0.0,0.0,-1.8174972534179688,1.8174972534179688,0.0,28.292148759708965,127.50350189208984,149.11770629882812,0.3770538616605548,-99.62294613833944,-1.5404341608187337,-0.45225080361767156,-0.09803965669154624,-30948000.0,-1.0
36,2022-02-24,GOOG,125.0,133.03700256347656,124.7645034790039,132.67349243164062,43166000.0,0.0,0.0,5.088493347167969,0.0,5.088493347167969,46.4519293605615,124.7645034790039,144.53524780273438,40.00349619181359,-59.99650380818642,-1.4918252741422577,-0.6601656977225888,-0.04277701442392001,12218000.0,1.0
37,2022-02-25,GOOG,133.52549743652344,135.38900756835938,131.76499938964844,134.51950073242188,26236000.0,0.0,0.0,1.84600830078125,0.0,1.84600830078125,51.584347410747554,124.7645034790039,143.84649658203125,51.12147982000028,-48.87852017999972,-1.2966412755149008,-0.7874608132810513,0.0029038681535102917,38454000.0,1.0
38,2022-02-28,GOOG,133.2845001220703,135.6405029296875,132.82525634765625,134.89100646972656,29676000.0,0.0,0.0,0.3715057373046875,0.0,0.3715057373046875,52.6384523870139,124.7645034790039,142.17550659179688,58.16151387212189,-41.83848612787811,-1.100713380920837,-0.8501113268090087,-0.0030228867169707074,68130000.0,1.0
39,2022-03-01,GOOG,134.47999572753906,136.11099243164062,133.3784942626953,134.16799926757812,24640000.0,0.0,0.0,-0.7230072021484375,0.7230072021484375,0.0,50.184895656063695,124.7645034790039,142.17550659179688,54.008926008777024,-45.991073991222976,-0.9899549808364725,-0.8780800576145015,-0.016547545841068434,43490000.0,-1.0
40,2022-03-02,GOOG,134.60824584960938,135.61549377441406,133.4324951171875,134.75149536132812,23966000.0,0.0,0.0,0.58349609375,0.0,0.58349609375,52.25715690571719,124.7645034790039,141.43099975585938,59.92256390560633,-40.07743609439366,-0.8471792609056763,-0.8718998982727365,-0.019900046402033356,67456000.0,1.0
41,2022-03-03,GOOG,135.97850036621094,136.71380615234375,133.43099975585938,134.30799865722656,19780000.0,0.0,0.0,-0.4434967041015625,0.4434967041015625,0.0,50.417793069691946,124.7645034790039,139.2832489013672,65.73223030360992,-34.26776969639007,-0.7597810983233728,-0.8494761382828638,0.015112380737103193,47676000.0,-1.0
42,2022-03-04,GOOG,133.38250732421875,134.19900512695312,130.4084930419922,132.1219940185547,24446000.0,0.0,0.0,-2.186004638671875,2.186004638671875,0.0,42.008368654406766,124.7645034790039,137.9459991455078,55.81681112445557,-44.18318887554443,-0.8511430761083147,-0.8498095258479541,0.012681282731238808,23230000.0,-1.0
43,2022-03-07,GOOG,131.9040069580078,131.9040069580078,126.41000366210938,126.4645004272461,39178000.0,0.0,0.0,-5.657493591308594,5.657493591308594,0.0,28.041381274897688,124.7645034790039,137.9459991455078,12.896844115817045,-87.10315588418295,-1.3501225794030915,-0.9498721365589816,-0.022704321738685418,-15948000.0,-1.0
44,2022-03-08,GOOG,126.25050354003906,131.2465057373047,125.86074829101562,127.27850341796876,35250000.0,0.0,0.0,0.8140029907226705,0.0,0.8140029907226705,31.80552297500506,124.7645034790039,137.9459991455078,19.07219030806418,-80.92780969193582,-1.6623314984853153,-1.0923640089442486,-0.002402286073623472,19302000.0,1.0
45,2022-03-09,GOOG,131.39999389648438,134.19850158691406,130.08799743652344,133.86599731445312,32258000.0,0.0,0.0,6.587493896484361,0.0,6.587493896484361,54.18441268394462,124.7645034790039,136.83949279785156,75.37475682270662,-24.625243177293385,-1.3764029831878588,-1.1491718037929706,0.008988267821674611,51560000.0,1.0
46,2022-03-10,GOOG,131.46249389648438,133.5384979248047,131.4010009765625,132.6820068359375,24266000.0,0.0,0.0,-1.183990478515625,1.183990478515625,0.0,50.731817614529426,124.7645034790039,136.71380615234375,66.25912468179737,-33.740875318202626,-1.2288358019994234,-1.1651046034342611,-0.013659684183183307,27294000.0,-1.0
47,2022-03-11,GOOG,133.99949645996094,134.1999969482422,130.29649353027344,130.47549438476562,26600000.0,0.0,0.0,-2.206512451171875,2.206512451171875,0.0,44.61830982510176,124.7645034790039,136.71380615234375,47.79350780446413,-52.20649219553587,-1.2711723391579994,-1.1863181505790088,-0.032733924970393846,694000.0,-1.0
48,2022-03-14,GOOG,130.572998046875,131.0260009765625,126.41300201416016,126.74099731445312,30254000.0,0.0,0.0,-3.7344970703125,3.7344970703125,0.0,36.11843359084461,124.7645034790039,136.71380615234375,16.540662576561772,-83.45933742343823,-1.581341938884293,-1.2653229082400657,-0.05535598647716988,-29560000.0,-1.0
49,2022-03-15,GOOG,127.7415008544922,130.51724243164062,126.56800079345705,129.66050720214844,30292000.0,0.0,0.0,2.9195098876953125,0.0,2.9195098876953125,45.48611946970527,124.7645034790039,136.71380615234375,40.973133386837986,-59.02686661316202,-1.5779031523651383,-1.3278389570650804,-0.03778056893193282,732000.0,1.0
50,2022-03-16,GOOG,131.0,133.77099609375,129.2010040283203,133.6905059814453,32058000.0,0.0,0.0,4.029998779296875,0.0,4.029998779296875,55.80770064205343,125.86074829101562,136.71380615234375,72.14333315524712,-27.856666844752876,-1.2415815768320329,-1.310587481018471,-0.004597586755478167,32790000.0,1.0
51,2022-03-17,GOOG,133.3209991455078,134.739501953125,132.718994140625,134.60049438476562,23994000.0,0.0,0.0,0.9099884033203125,0.0,0.9099884033203125,57.88525392426613,125.86074829101562,136.71380615234375,80.5279600037117,-19.47203999628831,-0.8926055515872804,-1.226991095132233,0.018759180745204773,56784000.0,1.0
52,2022-03-18,GOOG,133.88400268554688,136.9134979248047,132.9320068359375,136.80149841308594,45900000.0,0.0,0.0,2.2010040283203125,0.0,2.2010040283203125,62.76989561829119,125.86074829101562,136.9134979248047,98.98668190785432,-1.0133180921456804,-0.43624110089760393,-1.0688410962853072,0.08173833724814039,102684000.0,1.0
53,2022-03-21,GOOG,136.84750366210938,137.58250427246094,134.6114959716797,136.47850036621094,26632000.0,0.0,0.0,-0.322998046875,0.322998046875,0.0,61.56088437012481,125.86074829101562,137.58250427246094,90.58158258884114,-9.418417411158856,-0.09917955662413647,-0.8749087883530731,0.07228240984284984,76052000.0,-1.0
54,2022-03-22,GOOG,136.5,141.5,136.5,140.27749633789062,29776000.0,0.0,0.0,3.7989959716796875,0.0,3.7989959716796875,69.5264821110121,125.86074829101562,141.5,92.18310642441368,-7.81689357558633,0.464948346734559,-0.6069373613355467,0.04789490350097503,105828000.0,1.0
55,2022-03-23,GOOG,139.1385040283203,140.02499389648438,138.16650390625,138.5034942626953,25302000.0,0.0,0.0,-1.7740020751953125,1.7740020751953125,0.0,62.54321892186648,125.86074829101562,141.5,80.83983944332024,-19.16016055667975,0.7617868498381313,-0.333192519100811,0.043875485196392505,80526000.0,-1.0
56,2022-03-24,GOOG,139.2725067138672,141.39649963378906,138.03939819335938,141.31199645996094,20544000.0,0.0,0.0,2.808502197265625,0.0,2.808502197265625,68.35016909965441,125.86074829101562,141.5,98.7978738143139,-1.2021261856861027,1.2070661987371523,-0.025140775533218262,0.08305392615136609,101070000.0,1.0
57,2022-03-25,GOOG,141.75399780273438,141.95950317382812,139.69949340820312,141.52149963378906,19270000.0,0.0,0.0,0.209503173828125,0.0,0.209503173828125,68.76693861728042,125.86074829101562,141.95950317382812,97.27927070616693,-2.720729293833077,1.558631240144905,0.2916136276024065,0.1166197413033172,120340000.0,1.0
58,2022-03-28,GOOG,140.6844940185547,141.97650146484375,139.82815551757812,141.9499969482422,23774000.0,0.0,0.0,0.428497314453125,0.0,0.428497314453125,69.70829416952323,126.41300201416016,141.97650146484375,99.82970079007264,-0.17029920992735567,1.8500872401924084,0.6033083501204071,0.09478205824795749,144114000.0,1.0
59,2022-03-29,GOOG,143.16050720214844,144.16250610351562,142.48399353027344,143.25,28678000.0,0.0,0.0,1.3000030517578125,0.0,1.3000030517578125,72.59927590326433,126.41300201416016,144.16250610351562,94.85897691044302,-5.14102308955698,2.1600434772294363,0.9146553755422131,0.07150465882656953,172792000.0,1.0
60,2022-03-30,GOOG,142.8699951171875,143.48049926757812,142.16799926757812,142.64450073242188,21046000.0,0.0,0.0,-0.605499267578125,0.605499267578125,0.0,69.05727854084745,126.41300201416016,144.16250610351562,91.44761812244596,-8.552381877554039,2.3303163165135174,1.197787563736474,0.05976208619755785,151746000.0,-1.0
61,2022-03-31,GOOG,142.44850158691406,142.64450073242188,139.61900329589844,139.64950561523438,29516000.0,0.0,0.0,-2.9949951171875,2.9949951171875,0.0,54.01643304863064,126.41300201416016,144.16250610351562,74.57393476706915,-25.42606523293085,2.2000790943190793,1.3982458698529954,0.02081853806563272,122230000.0,-1.0
62,2022-04-01,GOOG,140.00999450683594,140.9499969482422,138.7969970703125,140.6999969482422,23480000.0,0.0,0.0,1.0504913330078125,0.0,1.0504913330078125,57.741397898787426,126.56800079345705,144.16250610351562,80.32050862325774,-19.679491376742263,2.1561396953341614,1.5498246349492288,0.030931586811869805,145710000.0,1.0
63,2022-04-04,GOOG,140.82449340820312,144.0437469482422,140.82449340820312,143.6425018310547,19076000.0,0.0,0.0,2.9425048828125,0.0,2.9425048828125,66.50963089612948,129.2010040283203,144.16250610351562,96.52438458486697,-3.4756154151330367,2.330265702487509,1.705912848456885,0.023988206098707998,164786000.0,1.0
64,2022-04-05,GOOG,143.39950561523438,143.58999633789062,140.94349670410156,141.06300354003906,19256000.0,0.0,0.0,-2.579498291015625,2.579498291015625,0.0,54.97226764658895,132.718994140625,144.16250610351562,72.91476101455807,-27.08523898544193,2.2356084181232063,1.8118519623901495,0.018479745157109262,145530000.0,-1.0
65,2022-04-06,GOOG,139.1614990234375,139.84849548339844,136.41810607910156,137.17599487304688,23574000.0,0.0,0.0,-3.8870086669921875,3.8870086669921875,0.0,42.23395389642584,132.9320068359375,144.16250610351562,37.789842962383254,-62.21015703761674,1.8276705400627975,1.815015677924679,-0.029268580803654243,121956000.0,-1.0
66,2022-04-07,GOOG,136.6179962158203,137.70150756835938,134.8572540283203,136.46499633789062,19448000.0,0.0,0.0,-0.71099853515625,0.71099853515625,0.0,40.264733947155136,134.6114959716797,144.16250610351562,19.40632813311286,-80.59367186688714,1.430824323528043,1.738177407045352,-0.035729576841561195,102508000.0,-1.0
67,2022-04-08,GOOG,136.25,136.25,133.75250244140625,134.010498046875,16434000.0,0.0,0.0,-2.454498291015625,2.454498291015625,0.0,33.9578528648744,133.75250244140625,144.16250610351562,2.4783430807792093,-97.52165691922079,0.9087776779029753,1.5722974612168767,-0.05593165954249435,86074000.0,-1.0
68,2022-04-11,GOOG,132.89999389648438,132.93919372558594,129.61749267578125,129.79649353027344,24188000.0,0.0,0.0,-4.2140045166015625,4.2140045166015625,0.0,25.916256824667656,129.61749267578125,144.16250610351562,1.2306681969153042,-98.7693318030847,0.1548116291243673,1.288800294798375,-0.0939162755303774,61886000.0,-1.0
69,2022-04-12,GOOG,132.42349243164062,132.42349243164062,127.57599639892578,128.37449645996094,23004000.0,0.0,0.0,-1.4219970703125,1.4219970703125,0.0,23.728385243344533,127.57599639892578,144.16250610351562,4.814153642066083,-95.18584635793391,-0.5505874787884864,0.9209227400810027,-0.10003893735258096,38882000.0,-1.0
70,2022-04-13,GOOG,128.62649536132812,130.65574645996094,128.4385986328125,130.28599548339844,19542000.0,0.0,0.0,1.9114990234375,0.0,1.9114990234375,32.55910608264831,127.57599639892578,144.16250610351562,16.338573531975452,-83.66142646802454,-0.9450587930687391,0.5477264334510543,-0.06705007719565081,58424000.0,1.0
71,2022-04-14,GOOG,130.64950561523438,130.7102508544922,127.11150360107422,127.25299835205078,23484000.0,0.0,0.0,-3.0329971313476562,3.0329971313476562,0.0,26.864563669836542,127.11150360107422,144.16250610351562,0.8298324450794193,-99.17016755492058,-1.484392881580618,0.14130257044471972,-0.09557213139910736,34940000.0,-1.0
72,2022-04-18,GOOG,127.41000366210938,128.71200561523438,126.57845306396484,127.96099853515624,14918000.0,0.0,0.0,0.7080001831054545,0.0,0.7080001831054545,30.154836959269076,126.57845306396484,144.16250610351562,7.86249602456108,-92.13750397543892,-1.8337155836234444,-0.25370106036891327,-0.10917035763093486,49858000.0,1.0
73,2022-04-19,GOOG,128.07699584960938,130.90374755859375,127.45149993896484,130.531005859375,22720000.0,0.0,0.0,2.570007324218764,0.0,2.570007324218764,41.22911114510908,126.57845306396484,144.0437469482422,22.630897719782055,-77.36910228021794,-1.8821082074146602,-0.5793824897780627,-0.0746616576732303,72578000.0,1.0
74,2022-04-20,GOOG,131.28399658203125,131.92349243164062,127.89405059814452,128.24549865722656,22610000.0,0.0,0.0,-2.2855072021484375,2.2855072021484375,0.0,35.45994399775614,126.57845306396484,144.0437469482422,9.544904336035428,-90.45509566396457,-2.0803548756015005,-0.8795769669427503,-0.06510247091034604,49968000.0,-1.0
75,2022-04-21,GOOG,129.35000610351562,130.3074951171875,124.6500015258789,124.9375,30158000.0,0.0,0.0,-3.3079986572265625,3.3079986572265625,0.0,28.742998064301318,124.6500015258789,144.0437469482422,1.4824288339351614,-98.51757116606484,-2.4751319008757946,-1.1986879537293593,-0.08447218442265048,19810000.0,-1.0
76,2022-04-22,GOOG,125.0,125.4520034790039,119.1405029296875,119.61399841308594,46410000.0,0.0,0.0,-5.3235015869140625,5.3235015869140625,0.0,21.263804820693053,119.1405029296875,144.0437469482422,1.9013405765355298,-98.09865942346447,-3.1798156081079583,-1.5949134846050794,-0.10742814811980905,-26600000.0,-1.0
77,2022-04-25,GOOG,119.42949676513672,123.27799987792967,118.76924896240234,123.25,34522000.0,0.0,0.0,3.6360015869140625,0.0,3.6360015869140625,34.66243030956517,118.76924896240234,143.58999633789062,18.052442055079375,-81.94755794492062,-3.406265437670129,-1.9571838752180895,-0.05043659772478015,7922000.0,1.0
78,2022-04-26,GOOG,122.75,122.75,119.16184997558594,119.50599670410156,49394000.0,0.0,0.0,-3.7440032958984375,3.7440032958984375,0.0,28.832892743021816,118.76924896240234,139.84849548339844,3.495133191622278,-96.50486680837773,-3.8428791315900526,-2.3343229264924825,-0.06908303440649055,-41472000.0,-1.0
79,2022-04-27,GOOG,114.3730010986328,117.5,113.12425231933594,115.02050018310548,62238000.0,0.0,0.0,-4.4854965209960795,4.4854965209960795,0.0,23.394088446569953,113.12425231933594,137.70150756835938,7.715458233868046,-92.28454176613195,-4.498252031109644,-2.767108747415915,-0.11716911893449167,-103710000.0,-1.0
80,2022-04-28,GOOG,117.11499786376952,120.4384994506836,115.1438980102539,119.4114990234375,36790000.0,0.0,0.0,4.390998840332017,0.0,4.390998840332017,36.84939089597224,113.12425231933594,136.25,27.187214834824413,-72.81278516517558,-4.610790613160631,-3.1358451205648588,-0.06162133254353219,-66920000.0,1.0
81,2022-04-29,GOOG,117.5780029296875,118.95999908447266,114.69400024414062,114.96649932861328,33694000.0,0.0,0.0,-4.444999694824219,4.444999694824219,0.0,30.576409667726338,113.12425231933594,132.93919372558594,9.297261957566349,-90.70273804243365,-5.000389357546112,-3.5087539679611095,-0.10155046737129692,-100614000.0,-1.0
82,2022-05-02,GOOG,113.90650177001952,117.3395004272461,113.39949798583984,117.15699768066406,30280000.0,0.0,0.0,2.1904983520507812,0.0,2.1904983520507812,36.70334808204705,113.12425231933594,132.42349243164062,20.89587640684854,-79.10412359315146,-5.0741578029582115,-3.82183473496053,-0.10245847789696161,-70334000.0,1.0
83,2022-05-03,GOOG,116.76499938964844,119.3000030517578,116.6269989013672,118.12950134277344,21216000.0,0.0,0.0,0.972503662109375,0.0,0.972503662109375,39.44119983347845,113.12425231933594,131.92349243164062,26.624741178561834,-73.37525882143817,-4.99664738697922,-4.056797265364269,-0.07887994058560355,-49118000.0,1.0
84,2022-05-04,GOOG,118.00350189208984,123.14299774169922,115.7385025024414,122.5749969482422,33232000.0,0.0,0.0,4.445495605468764,0.0,4.445495605468764,50.69073474149772,113.12425231933594,131.92349243164062,50.27195020888349,-49.72804979111651,-4.524815359095811,-4.150400884110577,-0.018909479153639164,-15886000.0,1.0
85,2022-05-05,GOOG,120.22049713134766,121.2332534790039,115.18250274658205,116.74649810791016,43090000.0,0.0,0.0,-5.8284988403320455,5.8284988403320455,0.0,39.57051350394076,113.12425231933594,131.92349243164062,19.268043638654024,-80.73195636134598,-4.567951935189811,-4.233911094326424,-0.02397294918001902,-58976000.0,-1.0
86,2022-05-06,GOOG,115.5189971923828,117.49849700927734,114.14299774169922,115.66000366210938,35310000.0,0.0,0.0,-1.0864944458007812,1.0864944458007812,0.0,37.78751147876819,113.12425231933594,131.92349243164062,13.488584259922876,-86.51141574007713,-4.636254140070761,-4.314379703475292,-0.06158212038856492,-94286000.0,-1.0
87,2022-05-09,GOOG,113.30349731445312,115.56289672851562,112.55149841308594,113.08399963378906,34520000.0,0.0,0.0,-2.5760040283203125,2.5760040283203125,0.0,33.64071856147011,112.55149841308594,131.92349243164062,2.748819869514156,-97.25118013048585,-4.842197275590806,-4.419943217898395,-0.05373786460451391,-128806000.0,-1.0
88,2022-05-10,GOOG,116.04049682617188,116.69100189208984,113.38330078125,114.58450317382812,31158000.0,0.0,0.0,1.5005035400390625,0.0,1.5005035400390625,38.19896887422293,112.55149841308594,130.3074951171875,11.449679759585514,-88.55032024041448,-4.828775671113689,-4.501709708541454,-0.003790602619387684,-97648000.0,1.0
89,2022-05-11,GOOG,113.71050262451172,116.6709976196289,113.6500015258789,113.96099853515624,36502000.0,0.0,0.0,-0.6235046386718892,0.6235046386718892,0.0,36.981028432180224,112.55149841308594,125.4520034790039,10.925929759091968,-89.07407024090803,-4.812916286390077,-4.563951024111179,-0.04564468692593393,-134150000.0,-1.0
90,2022-05-12,GOOG,111.93800354003906,114.85649871826172,110.1135025024414,113.16100311279295,41464000.0,0.0,0.0,-0.7999954223632812,0.7999954223632812,0.0,35.31409516285285,110.1135025024414,123.27799987792967,23.14938826320756,-76.85061173679244,-4.809398843661299,-4.613040588021203,-0.015704541987136666,-175614000.0,-1.0
91,2022-05-13,GOOG,114.84549713134766,118.08499908447266,114.0,116.5155029296875,29738000.0,0.0,0.0,3.3544998168945455,0.0,3.3544998168945455,46.89544501395317,110.1135025024414,123.14299774169922,49.134677204968725,-50.865322795031275,-4.484441837980825,-4.587320838013127,-0.005475513743746552,-145876000.0,1.0
92,2022-05-16,GOOG,115.38400268554688,116.60749816894533,114.33499908447266,114.7925033569336,23282000.0,0.0,0.0,-1.7229995727539062,1.7229995727539062,0.0,42.39674211182105,110.1135025024414,123.14299774169922,35.910837439000545,-64.08916256099945,-4.3160853379314545,-4.533073737996793,-0.028248641938790175,-169158000.0,-1.0
93,2022-05-17,GOOG,117.22750091552734,117.22750091552734,115.3375015258789,116.70149993896484,21576000.0,0.0,0.0,1.90899658203125,0.0,1.90899658203125,48.68936787882279,110.1135025024414,123.14299774169922,50.56218460922285,-49.43781539077715,-3.9828091503319314,-4.4230208204638215,-0.04791757826237164,-147582000.0,1.0
94,2022-05-18,GOOG,115.2375030517578,115.69564819335938,112.14199829101562,112.4010009765625,27982000.0,0.0,0.0,-4.300498962402344,4.300498962402344,0.0,37.9214565444369,110.1135025024414,123.14299774169922,17.556309220858154,-82.44369077914185,-4.01915164027281,-4.3422469844256195,-0.03722164862993205,-175564000.0,-1.0
95,2022-05-19,GOOG,111.84100341796876,113.5875015258789,110.46800231933594,110.74549865722656,29192000.0,0.0,0.0,-1.6555023193359375,1.6555023193359375,0.0,34.5295270416828,110.1135025024414,123.14299774169922,4.850503746921482,-95.14949625307851,-4.133805313576232,-4.300558650255742,-0.04249096359394999,-204756000.0,-1.0
96,2022-05-20,GOOG,112.08550262451172,112.5500030517578,106.3730010986328,109.31300354003906,37586000.0,0.0,0.0,-1.4324951171875,1.4324951171875,0.0,31.698692897378038,106.3730010986328,123.14299774169922,17.531323970907366,-82.46867602909263,-4.290732434973336,-4.298593407199261,-0.03334685814051486,-242342000.0,-1.0
97,2022-05-23,GOOG,110.10399627685548,112.00550079345705,109.1542510986328,111.66649627685548,31558000.0,0.0,0.0,2.3534927368164205,0.0,2.3534927368164205,40.88588150133771,106.3730010986328,123.14299774169922,31.565272736123585,-68.43472726387641,-4.177128540960467,-4.2743004339515025,-0.025465982014565625,-210784000.0,1.0
98,2022-05-24,GOOG,106.37750244140624,106.3949966430664,102.20800018310548,105.9260025024414,60386000.0,0.0,0.0,-5.740493774414077,5.740493774414077,0.0,29.658338456232997,102.20800018310548,121.2332534790039,19.542458970243892,-80.4575410297561,-4.49823935121529,-4.31908821740426,-0.07050654290499292,-271170000.0,-1.0
99,2022-05-25,GOOG,105.14199829101562,106.5447006225586,104.21125030517578,105.8395004272461,37900000.0,0.0,0.0,-0.0865020751953125,0.0865020751953125,0.0,29.517404800556335,102.20800018310548,118.08499908447266,22.872712070465038,-77.12728792953496,-4.705452537769446,-4.3963610814772975,-0.06469987437500158,-309070000.0,-1.0
100,2022-05-26,GOOG,106.05049896240234,108.95525360107422,105.48799896240234,108.2959976196289,30288000.0,0.0,0.0,2.4564971923828125,0.0,2.4564971923828125,39.01339032242666,102.20800018310548,118.08499908447266,38.344761968832685,-61.655238031167315,-4.618288138328765,-4.440746492847591,-0.07054430615142038,-278782000.0,1.0
101,2022-05-27,GOOG,109.78849792480467,112.86799621582033,109.5500030517578,112.79900360107422,29924000.0,0.0,0.0,4.5030059814453125,0.0,4.5030059814453125,52.538329860722186,102.20800018310548,118.08499908447266,66.70658279794137,-33.29341720205863,-4.138279972304787,-4.38025318873903,-0.017366114489731355,-248858000.0,1.0
102,2022-05-31,GOOG,113.0790023803711,116.43350219726562,112.57250213623048,114.03900146484376,51302000.0,0.0,0.0,1.2399978637695455,0.0,1.2399978637695455,55.66252476729622,102.20800018310548,118.08499908447266,74.5166095635335,-25.48339043646649,-3.6161603291629376,-4.227434616823812,-0.02281460371557842,-197556000.0,1.0
103,2022-06-01,GOOG,114.93150329589844,117.39900207519533,113.55049896240234,114.13700103759766,28630000.0,0.0,0.0,0.09799957275389204,0.0,0.09799957275389204,55.9270810443189,102.20800018310548,118.08499908447266,75.13385198675654,-24.866148013243464,-3.1580667997887417,-4.013561053416798,0.015444702858092407,-168926000.0,1.0
104,2022-06-02,GOOG,114.18800354003906,117.89800262451172,113.30799865722656,117.74600219726562,27472000.0,0.0,0.0,3.6090011596679688,0.0,3.6090011596679688,64.84142065901442,102.20800018310548,118.08499908447266,97.86485538411267,-2.135144615887327,-2.4753571040877063,-3.7059202635509796,0.06321253346564126,-141454000.0,1.0
105,2022-06-03,GOOG,115.99250030517578,116.364501953125,113.66799926757812,114.56400299072266,25052000.0,0.0,0.0,-3.1819992065429688,3.1819992065429688,0.0,53.776023677142334,102.20800018310548,117.89800262451172,78.75080232625987,-21.249197673740124,-2.166029190318511,-3.3979420489044863,0.04803636603727801,-166506000.0,-1.0
106,2022-06-06,GOOG,116.74250030517578,119.39849853515624,116.5282974243164,117.010498046875,23786000.0,0.0,0.0,2.4464950561523438,0.0,2.4464950561523438,59.85387767786857,102.20800018310548,119.39849853515624,86.10860232567744,-13.891397674322556,-1.7038800331892645,-3.059129645761442,0.04785680529252123,-142720000.0,1.0
107,2022-06-07,GOOG,115.64800262451172,117.74864959716795,115.12550354003906,117.22949981689452,26414000.0,0.0,0.0,0.21900177001951704,0.0,0.21900177001951704,60.39179962158029,102.20800018310548,119.39849853515624,87.38257219865318,-12.61742780134682,-1.304914038357282,-2.7082865242806102,0.10671126113904461,-116306000.0,1.0
108,2022-06-08,GOOG,116.87650299072266,118.64600372314452,116.69674682617188,117.23799896240234,22544000.0,0.0,0.0,0.00849914550782671,0.0,0.00849914550782671,60.41555028886413,102.20800018310548,119.39849853515624,87.43201314756442,-12.56798685243557,-0.9767855261968634,-2.361986324663861,0.10769607272467763,-93762000.0,1.0
109,2022-06-09,GOOG,116.34149932861328,118.3499984741211,114.86699676513672,114.91799926757812,23142000.0,0.0,0.0,-2.3199996948242188,2.3199996948242188,0.0,50.817842966213,102.20800018310548,119.39849853515624,73.93618744599335,-26.063812554006656,-0.8936086361842541,-2.0683107869679396,0.06114724268211513,-116904000.0,-1.0
110,2022-06-10,GOOG,112.78125,113.49700164794922,110.86100006103516,111.42749786376952,31324000.0,0.0,0.0,-3.490501403808608,3.490501403808608,0.0,39.83268821085823,102.20800018310548,119.39849853515624,53.63135781089318,-46.36864218910682,-1.0966519778188228,-1.873979025138116,-0.012158846208918495,-148228000.0,-1.0
111,2022-06-13,GOOG,107.4459991455078,109.21849822998048,106.58805084228516,106.87650299072266,36756000.0,0.0,0.0,-4.550994873046861,4.550994873046861,0.0,30.057769773773003,102.20800018310548,119.39849853515624,27.157460545989586,-72.8425394540104,-1.606214834484902,-1.8204261870074734,-0.06280744641848857,-184984000.0,-1.0
112,2022-06-14,GOOG,106.88999938964844,108.4574966430664,106.35199737548828,107.19400024414062,25480000.0,0.0,0.0,0.31749725341796875,0.0,0.31749725341796875,31.412644424394387,104.21125030517578,119.39849853515624,19.639831349281124,-80.36016865071888,-1.96181579431412,-1.848704108468803,-0.060830411964039155,-159504000.0,1.0
113,2022-06-15,GOOG,108.89949798583984,112.06300354003906,108.1187515258789,110.3905029296875,33192000.0,0.0,0.0,3.196502685546875,0.0,3.196502685546875,44.01174589356322,105.48799896240234,119.39849853515624,35.24319124302016,-64.75680875697985,-1.9631075963089444,-1.8715848060368316,-0.06246920600544126,-126312000.0,1.0
114,2022-06-16,GOOG,108.14949798583984,109.29049682617188,105.7925033569336,106.63600158691406,35314000.0,0.0,0.0,-3.7545013427734375,3.7545013427734375,0.0,35.23886029747797,105.7925033569336,119.39849853515624,6.199460009588622,-93.80053999041138,-2.2412121307171162,-1.9455102709728886,-0.06920150480819531,-161626000.0,-1.0
115,2022-06-17,GOOG,106.53500366210938,109.24949645996094,105.62854766845705,107.8655014038086,43516000.0,0.0,0.0,1.2294998168945312,0.0,1.2294998168945312,39.77488701249443,105.62854766845705,119.39849853515624,16.24518313105478,-83.75481686894523,-2.3354908849071307,-2.0235063937597375,-0.07815535183349853,-118110000.0,1.0
116,2022-06-21,GOOG,109.7020034790039,112.6729965209961,109.2935028076172,112.01499938964844,39010000.0,0.0,0.0,4.149497985839844,0.0,4.149497985839844,52.68137854412336,105.62854766845705,119.39849853515624,46.37962606414365,-53.62037393585635,-2.0517638028543246,-2.029157875578655,-0.04448112834560258,-79100000.0,1.0
117,2022-06-22,GOOG,111.16300201416016,113.76950073242188,110.72429656982422,112.03399658203124,23922000.0,0.0,0.0,0.01899719238279829,0.0,0.01899719238279829,52.734885846717106,105.62854766845705,119.39849853515624,46.517587285405085,-53.48241271459491,-1.8045731996392789,-1.9842409403907797,-0.04438835894870574,-55178000.0,1.0
118,2022-06-23,GOOG,112.9499969482422,113.19650268554688,111.02899932861328,112.68450164794922,24710000.0,0.0,0.0,0.650505065917983,0.0,0.650505065917983,54.756268611887606,105.62854766845705,119.39849853515624,51.24167869441035,-48.75832130558964,-1.5384532645941675,-1.8950834052314576,-0.01943557696674103,-30468000.0,1.0
119,2022-06-24,GOOG,113.60299682617188,118.6374969482422,113.60299682617188,118.53800201416016,39122000.0,0.0,0.0,5.8535003662109375,0.0,5.8535003662109375,68.66861349146916,105.62854766845705,119.39849853515624,93.75091073798181,-6.249089262018188,-0.8455188901645272,-1.6851705022180716,0.06381283154256856,8654000.0,1.0
120,2022-06-27,GOOG,118.93499755859376,119.25,116.00074768066406,116.62249755859376,32840000.0,0.0,0.0,-1.915504455566392,1.915504455566392,0.0,61.52513239122258,105.62854766845705,119.25,80.71055583902918,-19.289444160970817,-0.44577746739270196,-1.4372918952529976,0.09118931004616715,-24186000.0,-1.0
121,2022-06-28,GOOG,116.35099792480467,117.85649871826172,112.44400024414062,112.57150268554688,28232000.0,0.0,0.0,-4.050994873046889,4.050994873046889,0.0,49.06895317200007,105.62854766845705,119.25,50.97073974272297,-49.02926025727703,-0.45064110409643376,-1.2399617370216849,0.05016607673152107,-52418000.0,-1.0
122,2022-06-29,GOOG,112.14849853515624,113.66449737548828,111.5540008544922,112.25650024414062,18628000.0,0.0,0.0,-0.31500244140625,0.31500244140625,0.0,48.1935238146153,105.62854766845705,119.25,48.65819307927502,-51.341806920724984,-0.4744426639803976,-1.0868579224134274,0.016903603706214243,-71046000.0,-1.0
123,2022-06-30,GOOG,110.49949645996094,111.32980346679688,107.30999755859376,109.37249755859376,38046000.0,0.0,0.0,-2.884002685546861,2.884002685546861,0.0,40.55087075152593,105.62854766845705,119.25,27.485688008957172,-72.51431199104283,-0.7177313575646025,-1.0130326094436624,0.02566202718553079,-109092000.0,-1.0
124,2022-07-01,GOOG,108.33699798583984,109.8063507080078,107.1050033569336,109.08100128173828,31028000.0,0.0,0.0,-0.29149627685548296,0.29149627685548296,0.0,39.81452420946524,105.62854766845705,119.25,25.345708587082527,-74.65429141291747,-0.9234144781300984,-0.9951089831809495,0.011268662010658126,-140120000.0,-1.0
125,2022-07-05,GOOG,107.5145034790039,114.05259704589844,106.24949645996094,113.88700103759766,36398000.0,0.0,0.0,4.805999755859375,0.0,4.805999755859375,55.26728189736189,105.62854766845705,119.25,60.62828814528578,-39.37171185471422,-0.6906760477528593,-0.9342223960953315,0.016712062296562635,-103722000.0,1.0
126,2022-07-06,GOOG,114.09200286865234,116.35199737548828,112.25050354003906,115.2135009765625,28852000.0,0.0,0.0,1.3264999389648438,0.0,1.3264999389648438,58.64852717293672,105.62854766845705,119.25,70.36660316983784,-29.633396830162162,-0.39464816255956237,-0.8263075493881779,0.028379817658323425,-74870000.0,1.0
127,2022-07-07,GOOG,116.00800323486328,119.86199951171876,115.53399658203124,119.30599975585938,32184000.0,0.0,0.0,4.092498779296875,0.0,4.092498779296875,67.41616841492859,105.62854766845705,119.86199951171876,96.09371105490054,-3.90628894509947,0.16823098407542147,-0.627399842695458,0.05876139141651571,-42686000.0,1.0
128,2022-07-08,GOOG,117.5500030517578,120.43499755859376,117.51399993896484,120.1685028076172,29082000.0,0.0,0.0,0.8625030517578267,0.0,0.8625030517578267,69.01381209959717,105.62854766845705,120.43499755859376,98.20014417396511,-1.7998558260348914,0.6761162724534273,-0.3666966196656809,0.013755089218242977,-13604000.0,1.0
129,2022-07-11,GOOG,118.6500015258789,118.79450225830078,116.2344970703125,116.52249908447266,26718000.0,0.0,0.0,-3.6460037231445455,3.6460037231445455,0.0,55.69418659537237,106.24949645996094,120.43499755859376,72.4190323139294,-27.580967686070583,0.7754896989751927,-0.13825935593750613,-0.0008574544038628673,-40322000.0,-1.0
130,2022-07-12,GOOG,116.8385009765625,117.84950256347656,114.61499786376952,114.84950256347656,24970000.0,0.0,0.0,-1.6729965209960938,1.6729965209960938,0.0,50.53076370084469,106.24949645996094,120.43499755859376,60.62532471513804,-39.37467528486196,0.7110555593346959,0.03160362711693433,0.020236026201879698,-65292000.0,-1.0
131,2022-07-13,GOOG,112.63899993896484,115.15699768066406,111.822998046875,112.18699645996094,38958000.0,0.0,0.0,-2.662506103515625,2.662506103515625,0.0,43.17968921014271,106.24949645996094,120.43499755859376,41.85611744496108,-58.143882555038914,0.44008373984490845,0.11329964966252919,-0.0006191515326821051,-104250000.0,-1.0
132,2022-07-14,GOOG,110.82599639892578,111.9875030517578,109.32550048828124,111.44000244140624,32366000.0,0.0,0.0,-0.7469940185547017,0.7469940185547017,0.0,41.237627388296254,106.24949645996094,120.43499755859376,36.59021944558272,-63.40978055441728,0.16318146493570396,0.12327601271716415,0.018903334283875584,-136616000.0,-1.0
133,2022-07-15,GOOG,112.96299743652344,114.00050354003906,111.82250213623048,112.76699829101562,34330000.0,0.0,0.0,1.3269958496093892,0.0,1.3269958496093892,46.197665419911125,106.24949645996094,120.43499755859376,45.94481214119981,-54.05518785880019,0.050229652919597356,0.10866674075765079,0.03379137490457218,-102286000.0,1.0
134,2022-07-18,GOOG,113.44000244140624,114.8000030517578,109.3000030517578,109.91000366210938,33354000.0,0.0,20.0,-2.85699462890625,2.85699462890625,0.0,38.18973799110365,106.24949645996094,120.43499755859376,25.80456747136857,-74.19543252863143,-0.2667396403953859,0.03358546452704343,-0.034920555807553044,-135640000.0,-1.0
135,2022-07-19,GOOG,111.7300033569336,114.80999755859376,110.5,114.62000274658205,30992300.0,0.0,0.0,4.7099990844726705,0.0,4.7099990844726705,53.516707340835936,106.24949645996094,120.43499755859376,59.007476919005995,-40.992523080994,-0.13632104902960407,-0.0003958381842860793,-0.005151290646928541,-104647700.0,1.0
136,2022-07-20,GOOG,114.05999755859376,116.33000183105467,113.26000213623048,114.6999969482422,26780100.0,0.0,0.0,0.07999420166015625,0.0,0.07999420166015625,53.741495218966186,106.24949645996094,120.43499755859376,59.57139215262342,-40.42860784737658,-0.026206603540799733,-0.005557991255588812,-0.038606631829435356,-77867600.0,1.0
137,2022-07-21,GOOG,115.08999633789062,115.20999908447266,111.91000366210938,115.04000091552734,27267800.0,0.0,0.0,0.34000396728514204,0.0,0.34000396728514204,54.813165784508335,106.24949645996094,120.43499755859376,61.96823358191851,-38.03176641808149,0.08748623313867654,0.013050853623264263,-0.04267758832196067,-50599800.0,1.0
138,2022-07-22,GOOG,111.80999755859376,113.18000030517578,107.5999984741211,108.36000061035156,44455300.0,0.0,0.0,-6.680000305175781,6.680000305175781,0.0,35.93876236906681,106.24949645996094,120.43499755859376,14.877896351465733,-85.12210364853426,-0.35730153898218475,-0.061019624897825565,-0.07005083600381512,-95055100.0,-1.0
139,2022-07-25,GOOG,108.87999725341795,110.58000183105467,107.01000213623048,108.20999908447266,28289900.0,0.0,0.0,-0.15000152587890625,0.15000152587890625,0.0,35.62095714369123,107.01000213623048,120.43499755859376,8.938527801977685,-91.06147219802232,-0.7136757747600342,-0.19155085487026732,-0.057810467880209604,-123345000.0,-1.0
140,2022-07-26,GOOG,107.43000030517578,107.73999786376952,104.76000213623048,105.44000244140624,36626600.0,0.0,0.0,-2.7699966430664205,2.7699966430664205,0.0,29.973347864261598,104.76000213623048,120.43499755859376,4.338121236103244,-95.66187876389675,-1.2057176292826028,-0.3943842097527345,-0.06014060658948717,-159971600.0,-1.0
141,2022-07-27,GOOG,109.5999984741211,114.4000015258789,108.41999816894533,113.5999984741211,41474600.0,0.0,0.0,8.159996032714858,0.0,8.159996032714858,54.49599292010653,104.76000213623048,120.43499755859376,56.395527396956815,-43.604472603043185,-0.9265510033192754,-0.5008175684660428,0.019382591398008575,-118497000.0,1.0
142,2022-07-28,GOOG,112.8000030517578,114.6999969482422,111.85099792480467,114.58999633789062,23303800.0,0.0,0.0,0.9899978637695312,0.0,0.9899978637695312,56.622471295779235,104.76000213623048,118.79450225830078,70.0416410713606,-29.958358928639413,-0.6182987735924144,-0.5243138094913171,0.016166059880129424,-95193200.0,1.0
143,2022-07-29,GOOG,113.4000015258789,116.9000015258789,113.2300033569336,116.63999938964844,31336200.0,0.0,0.0,2.0500030517578125,0.0,2.0500030517578125,60.979336602982855,104.76000213623048,117.84950256347656,90.75974533519616,-9.240254664803844,-0.20621383377169877,-0.4606938143473934,0.06123187611046532,-63857000.0,1.0
144,2022-08-01,GOOG,115.52999877929688,117.12000274658205,114.69000244140624,115.4800033569336,22856200.0,0.0,0.0,-1.1599960327148438,1.1599960327148438,0.0,57.22652627133694,104.76000213623048,117.12000274658205,86.7313971790993,-13.268602820900705,0.026460629545738357,-0.36326292556876705,0.007503058713520971,-86713200.0,-1.0
145,2022-08-02,GOOG,114.43000030517578,117.08000183105467,114.26000213623048,115.9000015258789,17911000.0,0.0,0.0,0.4199981689453125,0.0,0.4199981689453125,58.298693146292266,104.76000213623048,117.12000274658205,90.12944044936873,-9.870559550631269,0.2419575788174484,-0.24221882469152395,0.010462115166212316,-68802200.0,1.0
146,2022-08-03,GOOG,116.33999633789062,119.41999816894533,116.1500015258789,118.77999877929688,25302800.0,0.0,0.0,2.8799972534179688,0.0,2.8799972534179688,65.20037599777373,104.76000213623048,119.41999816894533,95.6343822452595,-4.365617754740497,0.6377776044592451,-0.06621953886137008,0.032510412326194116,-43499400.0,1.0
147,2022-08-04,GOOG,118.3000030517578,119.5,117.70999908447266,118.87000274658205,15757700.0,0.0,0.0,0.09000396728517046,0.0,0.09000396728517046,65.406825215092,104.76000213623048,119.5,95.72593388926826,-4.274066110731734,0.9478045616889972,0.13658528124870345,0.09699152895008822,-27741700.0,1.0
148,2022-08-05,GOOG,116.93000030517578,118.86000061035156,116.70999908447266,118.22000122070312,15615700.0,0.0,0.0,-0.6500015258789205,0.6500015258789205,0.0,62.325719363658855,104.76000213623048,119.5,91.3161535630675,-8.683846436932495,1.1280504658375037,0.3348783181664636,0.0925053342659794,-43357400.0,-1.0
149,2022-08-08,GOOG,119.12000274658205,120.86000061035156,117.83000183105467,118.13999938964844,17061100.0,0.0,0.0,-0.0800018310546875,0.0800018310546875,0.0,61.91153985088882,104.76000213623048,120.86000061035156,83.10558087893475,-16.894419121065248,1.2500316003871745,0.5179089746106058,0.12044761621946742,-60418500.0,-1.0
150,2022-08-09,GOOG,117.98999786376952,118.1999969482422,116.55999755859376,117.5,15424300.0,0.0,0.0,-0.6399993896484375,0.6399993896484375,0.0,58.333331438759586,104.76000213623048,120.86000061035156,79.13042901368978,-20.86957098631023,1.2803018043338454,0.6703875405552538,0.03433099980866072,-75842800.0,-1.0
151,2022-08-10,GOOG,119.58999633789062,121.77999877929688,119.36000061035156,120.6500015258789,20497000.0,0.0,0.0,3.1500015258789062,0.0,3.1500015258789062,68.62983797388276,104.76000213623048,121.77999877929688,93.36076688429719,-6.6392331157028,1.5407076554337635,0.844451563530956,0.052884242793054925,-55345800.0,1.0
152,2022-08-11,GOOG,122.08000183105467,122.33999633789062,119.5500030517578,119.81999969482422,16671600.0,0.0,0.0,-0.8300018310546875,0.8300018310546875,0.0,63.83394996264763,104.76000213623048,122.33999633789062,85.66554337754881,-14.334456622451183,1.6609608729532113,1.007753425415407,0.027263377244650444,-72017400.0,-1.0
153,2022-08-12,GOOG,121.16000366210938,122.6500015258789,120.4000015258789,122.6500015258789,16121100.0,0.0,0.0,2.8300018310546875,0.0,2.8300018310546875,71.63276526242092,104.76000213623048,122.6500015258789,100.0,-0.0,1.9620016375288856,1.1986030678381028,0.06208865570244049,-55896300.0,1.0
154,2022-08-15,GOOG,122.20999908447266,123.26000213623048,121.56999969482422,122.87999725341795,15525000.0,0.0,0.0,0.2299957275390483,0.0,0.2299957275390483,72.19501743472003,108.41999816894533,123.26000213623048,97.43932088124605,-2.560679118753948,2.1938478773518995,1.3976520297408623,0.060224293663883266,-40371300.0,1.0
155,2022-08-16,GOOG,122.31999969482422,123.22799682617188,121.53500366210938,122.51000213623048,15626200.0,0.0,0.0,-0.3699951171874716,0.3699951171874716,0.0,69.63316331820546,111.85099792480467,123.26000213623048,93.42624486676151,-6.573755133238493,2.320977527166292,1.5823171292259486,0.03140262161362939,-55997500.0,-1.0
156,2022-08-17,GOOG,120.93000030517578,122.1500015258789,120.1999969482422,120.31999969482422,17589200.0,0.0,0.0,-2.190002441406264,2.190002441406264,0.0,56.04953733950201,113.2300033569336,123.26000213623048,70.68790828295235,-29.312091717047657,2.21943048132799,1.709739799646357,0.012198173759055075,-73586700.0,-1.0
157,2022-08-18,GOOG,120.2300033569336,121.69000244140624,119.5500030517578,120.86000061035156,15652000.0,0.0,0.0,0.5400009155273438,0.0,0.5400009155273438,58.36055027038749,114.26000213623048,123.26000213623048,73.3333163791231,-26.666683620876896,2.1576549466104638,1.7993228290391783,0.022331241434517146,-57934700.0,1.0
158,2022-08-19,GOOG,119.87000274658205,120.0,117.66999816894533,118.12000274658205,20187000.0,0.0,0.0,-2.739997863769517,2.739997863769517,0.0,44.623192785966864,114.26000213623048,123.26000213623048,42.88889567057292,-57.111104329427086,1.8660922915174893,1.8126767215348407,-0.0001692622580811154,-78121700.0,-1.0
159,2022-08-22,GOOG,116.0999984741211,116.5,114.66999816894533,115.06999969482422,19316000.0,0.0,0.0,-3.0500030517578267,3.0500030517578267,0.0,34.26411128074078,114.66999816894533,123.26000213623048,4.656593028388452,-95.34340697161154,1.3730899283842888,1.7247593629047304,-0.02068085366107053,-97437700.0,-1.0
160,2022-08-23,GOOG,114.31999969482422,115.93000030517578,114.3000030517578,114.7699966430664,14390700.0,0.0,0.0,-0.3000030517578125,0.3000030517578125,0.0,33.38452367930563,114.3000030517578,123.26000213623048,5.245464724690517,-94.75453527530948,0.9472550018039954,1.5692584906845835,-0.04873605311601481,-111828400.0,-1.0
161,2022-08-24,GOOG,114.4499969482422,115.71700286865234,113.77999877929688,114.6999969482422,16051200.0,0.0,0.0,-0.06999969482420454,0.06999969482420454,0.0,33.15537783295626,113.77999877929688,123.26000213623048,9.704618598815648,-90.29538140118434,0.5972447282577491,1.3748557381992168,-0.042730785842283625,-127879600.0,-1.0
162,2022-08-25,GOOG,115.1500015258789,117.77999877929688,115.0500030517578,117.6999969482422,14874700.0,0.0,0.0,3.0,0.0,3.0,50.094422274834265,113.77999877929688,123.26000213623048,41.35017701315757,-58.64982298684242,0.555529402735317,1.210990471106437,-0.040358781215280026,-113004900.0,1.0
163,2022-08-26,GOOG,115.80999755859376,116.5999984741211,111.22000122070312,111.3000030517578,31698700.0,0.0,0.0,-6.399993896484403,6.399993896484403,0.0,30.85057478601385,111.22000122070312,123.26000213623048,0.6644669848114306,-99.33553301518857,0.005976374887623592,0.9699876518626743,-0.09423823616937832,-144703600.0,-1.0
164,2022-08-29,GOOG,110.77999877929688,111.95999908447266,109.80999755859376,110.33999633789062,20386100.0,0.0,0.0,-0.9600067138671733,0.9600067138671733,0.0,28.927251362937483,109.80999755859376,123.26000213623048,3.940510029105032,-96.05948997089497,-0.5012347199769778,0.6757431774947439,-0.09933887508063932,-165089700.0,-1.0
165,2022-08-30,GOOG,111.02999877929688,111.37000274658205,108.8000030517578,109.91000366210938,20548200.0,0.0,0.0,-0.42999267578125,0.42999267578125,0.0,28.024311740993994,108.8000030517578,123.26000213623048,7.676353254707383,-92.32364674529262,-0.9272115571874622,0.35515223055830264,-0.08651924916155607,-185637900.0,-1.0
166,2022-08-31,GOOG,111.62999725341795,111.7699966430664,109.0500030517578,109.1500015258789,25898000.0,0.0,0.0,-0.7600021362304688,0.7600021362304688,0.0,26.34710679388455,108.8000030517578,123.26000213623048,2.420459863631253,-97.57954013636875,-1.3110143687734137,0.021918910691959288,-0.09688895437147382,-211535900.0,-1.0
167,2022-09-01,GOOG,109.1999969482422,111.22000122070312,108.19000244140624,110.5500030517578,22784400.0,0.0,0.0,1.400001525878892,0.0,1.400001525878892,34.65897630141497,108.19000244140624,123.26000213623048,15.660256523841195,-84.3397434761588,-1.4850934464062107,-0.27948356072767483,-0.0640873647037169,-188751500.0,1.0
168,2022-09-02,GOOG,111.33999633789062,111.6750030517578,108.12999725341795,108.68000030517578,20618100.0,0.0,0.0,-1.870002746582017,1.870002746582017,0.0,29.523926471788783,108.12999725341795,123.22799682617188,3.642886920929383,-96.35711307907061,-1.7537297340139162,-0.5743327953849232,-0.05553141050313093,-209369600.0,-1.0
169,2022-09-06,GOOG,108.13500213623048,108.87999725341795,106.51000213623048,107.4800033569336,20565100.0,0.0,0.0,-1.1999969482421875,1.1999969482421875,0.0,26.605273484934315,106.51000213623048,122.1500015258789,6.202054082848118,-93.79794591715188,-2.039940291723724,-0.8674542946526834,-0.06351828438929574,-229934700.0,-1.0
170,2022-09-07,GOOG,107.76000213623048,110.98999786376952,107.61499786376952,110.4800033569336,22987200.0,0.0,0.0,3.0,0.0,3.0,42.89084785185377,106.51000213623048,121.69000244140624,26.152840190322685,-73.84715980967731,-2.001616326411849,-1.0942867010045167,-0.03679157544540179,-206947500.0,1.0
171,2022-09-08,GOOG,109.18000030517578,110.58000183105467,108.05999755859376,109.41999816894533,21660700.0,0.0,0.0,-1.060005187988267,1.060005187988267,0.0,39.332680197496906,106.51000213623048,120.0,21.57150847688646,-78.42849152311354,-2.0333386581150137,-1.2820970924266162,-0.07034833469824087,-228608200.0,-1.0
172,2022-09-09,GOOG,110.0500030517578,112.0,110.0,111.77999877929688,21732900.0,0.0,0.0,2.3600006103515483,0.0,2.3600006103515483,49.99045846138601,106.51000213623048,117.77999877929688,46.76129736301773,-53.23870263698226,-1.8467585116214877,-1.3950293762655905,0.004312629958472369,-206875300.0,1.0
173,2022-09-12,GOOG,111.98999786376952,112.63999938964844,110.93000030517578,111.87000274658205,19732900.0,0.0,0.0,0.09000396728517046,0.0,0.09000396728517046,50.37409306464829,106.51000213623048,117.77999877929688,47.55991310475838,-52.44008689524162,-1.6723520084903356,-1.4504939027105397,0.013866290189154418,-187142400.0,1.0
174,2022-09-13,GOOG,108.88999938964844,109.37000274658205,105.0,105.30999755859376,33015000.0,0.0,0.0,-6.560005187988281,6.560005187988281,0.0,30.619905244700135,105.0,117.77999877929688,2.4256462300759276,-97.57435376992407,-2.039955161956101,-1.5683861545596522,-0.041852478848578456,-220157400.0,-1.0
175,2022-09-14,GOOG,105.44000244140624,106.0999984741211,104.5,105.87000274658205,22115800.0,0.0,0.0,0.5600051879882812,0.0,0.5600051879882812,33.20016313436102,104.5,117.77999877929688,10.316286690612046,-89.68371330938795,-2.260043244998414,-1.7067175726474046,-0.030050377768608527,-198041600.0,1.0
176,2022-09-15,GOOG,105.01000213623048,106.20999908447266,103.30999755859376,103.9000015258789,26494900.0,0.0,0.0,-1.9700012207031392,1.9700012207031392,0.0,28.84572576829781,103.30999755859376,116.5999984741211,4.439457687288892,-95.5605423127111,-2.563872359917113,-1.8781485301013465,-0.06015378871374133,-224536500.0,-1.0
177,2022-09-16,GOOG,102.97000122070312,104.02999877929688,101.8550033569336,103.62999725341795,64540100.0,0.0,0.0,-0.2700042724609517,0.2700042724609517,0.0,28.259574780800293,101.8550033569336,112.63999938964844,16.457993040518087,-83.54200695948192,-2.7942359668199117,-2.0613660174450597,-0.046466719153269276,-289076600.0,-1.0
178,2022-09-19,GOOG,102.54000091552734,104.0199966430664,102.37000274658205,103.8499984741211,19738600.0,0.0,0.0,0.2200012207031392,0.0,0.2200012207031392,29.604430573012422,101.8550033569336,112.63999938964844,18.497875299498943,-81.50212470050106,-2.925327184035609,-2.2341582507631697,-0.03377376971935431,-269338000.0,1.0
179,2022-09-20,GOOG,102.87999725341795,103.16999816894533,101.12000274658205,101.83000183105467,24001700.0,0.0,0.0,-2.0199966430664205,2.0199966430664205,0.0,24.69911805881779,101.12000274658205,112.63999938964844,6.163188293114297,-93.8368117068857,-3.1558360993876278,-2.4184938204880613,-0.07829472540775462,-293339700.0,-1.0
180,2022-09-21,GOOG,102.23999786376952,103.48999786376952,99.98999786376952,100.01000213623048,26596800.0,0.0,0.0,-1.8199996948241903,1.8199996948241903,0.0,21.06970071634278,99.98999786376952,112.63999938964844,0.15813652211853016,-99.84186347788146,-3.445655342084052,-2.6239261248072596,-0.0859988684900701,-319936500.0,-1.0
181,2022-09-22,GOOG,99.4499969482422,101.68000030517578,99.41000366210938,100.56999969482422,21272700.0,0.0,0.0,0.5599975585937358,0.0,0.5599975585937358,24.98329819253044,99.41000366210938,112.63999938964844,8.767924469546424,-91.23207553045359,-3.588782829934118,-2.8168974658326316,-0.10028626951952424,-298663800.0,1.0
182,2022-09-23,GOOG,100.05999755859376,100.11000061035156,98.01000213623048,99.16999816894533,25657000.0,0.0,0.0,-1.400001525878892,1.400001525878892,0.0,21.857108064213904,98.01000213623048,112.63999938964844,7.928887563145906,-92.0711124368541,-3.771702888920615,-3.0078585504502287,-0.11352466493100843,-324320800.0,-1.0
183,2022-09-26,GOOG,98.61000061035156,100.44000244140624,98.37999725341795,98.80999755859376,22437900.0,0.0,0.0,-0.3600006103515625,0.3600006103515625,0.0,21.074671626772655,98.01000213623048,112.63999938964844,5.468185731725829,-94.53181426827418,-3.900751929033788,-3.186437226166941,-0.061722534903520865,-346758700.0,-1.0
184,2022-09-27,GOOG,99.91000366210938,100.45999908447266,97.33999633789062,98.08999633789062,24225000.0,0.0,0.0,-0.7200012207031392,0.7200012207031392,0.0,19.46653506369087,97.33999633789062,112.63999938964844,4.901959806562474,-95.09804019343753,-4.014841668042479,-3.352118114542049,-0.07348640981255283,-370983700.0,-1.0
185,2022-09-28,GOOG,98.0199966430664,101.4000015258789,97.8000030517578,100.73999786376952,24617000.0,0.0,0.0,2.650001525878892,0.0,2.650001525878892,39.176790103377726,97.33999633789062,112.63999938964844,22.222227762812548,-77.77777223718745,-3.8470790154654253,-3.4511102947267247,-0.030413894280091114,-346366700.0,1.0
186,2022-09-29,GOOG,99.3000030517578,99.3000030517578,96.5199966430664,98.08999633789062,21921500.0,0.0,0.0,-2.650001525878892,2.650001525878892,0.0,30.549601148195052,96.5199966430664,112.63999938964844,9.739450541701117,-90.26054945829888,-3.883195703456238,-3.537527376472627,-0.05345943319847579,-368288200.0,-1.0
187,2022-09-30,GOOG,97.7300033569336,99.49400329589844,96.02999877929688,96.1500015258789,26277800.0,0.0,0.0,-1.9399948120117188,1.9399948120117188,0.0,25.758239162186612,96.02999877929688,109.37000274658205,0.8995705464280537,-99.10042945357195,-4.021996653839807,-3.634421231946064,-0.074145373725364,-394566000.0,-1.0
188,2022-10-03,GOOG,97.22000122070312,99.97000122070312,97.0199966430664,99.3000030517578,24840000.0,0.0,0.0,3.150001525878892,0.0,3.150001525878892,42.61907457194702,96.02999877929688,106.20999908447266,32.12184847183518,-67.87815152816482,-3.8336270529344745,-3.674262396143746,-0.024845318018302476,-369726000.0,1.0
189,2022-10-04,GOOG,101.04000091552734,102.72000122070312,101.04000091552734,102.41000366210938,22580900.0,0.0,0.0,3.1100006103515767,0.0,3.1100006103515767,54.41323899894096,96.02999877929688,106.20999908447266,62.671951783427126,-37.328048216572874,-3.3942648585458812,-3.618262888624173,0.023997614984646143,-347145100.0,1.0
190,2022-10-05,GOOG,100.69000244140624,102.73999786376952,99.73999786376952,102.22000122070312,18475500.0,0.0,0.0,-0.19000244140625,0.19000244140625,0.0,53.636091653179825,96.02999877929688,104.02999877929688,77.37503051757812,-22.624969482421875,-3.026511021460095,-3.4999125151913573,0.016406498268725977,-365620600.0,-1.0
191,2022-10-06,GOOG,101.5,103.7300033569336,101.5,102.23999786376952,17156200.0,0.0,0.0,0.01999664306639204,0.0,0.01999664306639204,53.716365129039794,96.02999877929688,104.0199966430664,77.72216201247994,-22.27783798752005,-2.7022994678304286,-3.340389905719172,0.030956940118060272,-348464400.0,1.0
192,2022-10-07,GOOG,100.6500015258789,101.41999816894533,99.20999908447266,99.56999969482422,24249900.0,0.0,0.0,-2.6699981689452983,2.6699981689452983,0.0,42.40508529859374,96.02999877929688,103.7300033569336,45.97401053252151,-54.02598946747849,-2.6304833676228867,-3.198408598099915,0.007691551007070752,-372714300.0,-1.0
193,2022-10-10,GOOG,99.8499984741211,99.98999786376952,97.87000274658205,98.70999908447266,16529900.0,0.0,0.0,-0.8600006103515625,0.8600006103515625,0.0,39.32732206848428,96.02999877929688,103.7300033569336,34.80517807689831,-65.1948219231017,-2.6128441889491825,-3.0812957162697687,0.006320754100614945,-389244200.0,-1.0
194,2022-10-11,GOOG,98.25,100.12000274658205,97.25,98.0500030517578,21617700.0,0.0,0.0,-0.659996032714858,0.659996032714858,0.0,36.95239473202846,96.02999877929688,103.7300033569336,26.233806124319237,-73.76619387568077,-2.6218975574725363,-2.9894160845103226,-0.026702351290987636,-410861900.0,-1.0
195,2022-10-12,GOOG,98.2699966430664,99.64800262451172,97.66999816894533,98.3000030517578,17343400.0,0.0,0.0,0.25,0.0,0.25,38.573671283586165,96.02999877929688,103.7300033569336,29.480557440884432,-70.51944255911557,-2.579168461992623,-2.907366560006783,0.002140959544373544,-393518500.0,1.0
196,2022-10-13,GOOG,95.93000030517578,100.52999877929688,95.2699966430664,99.70999908447266,32812200.0,0.0,0.0,1.409996032714858,0.0,1.409996032714858,47.37948318019486,95.2699966430664,103.7300033569336,52.48225671178768,-47.51774328821232,-2.4038207273857353,-2.8066573934825736,0.03702545504001442,-360706300.0,1.0
197,2022-10-14,GOOG,100.625,101.29000091552734,97.02999877929688,97.18000030517578,22624800.0,0.0,0.0,-2.529998779296875,2.529998779296875,0.0,36.53566573644092,95.2699966430664,103.7300033569336,22.57685752162111,-77.42314247837889,-2.4408692739038145,-2.733499769566822,-0.021349473126169194,-383331100.0,-1.0
198,2022-10-17,GOOG,99.5199966430664,101.7699966430664,99.51000213623048,100.77999877929688,23311600.0,0.0,0.0,3.5999984741210938,0.0,3.5999984741210938,53.86994423843301,95.2699966430664,103.7300033569336,65.1299972043612,-34.870002795638804,-2.1549004318936085,-2.6177799020321793,-0.015916461522553216,-360019500.0,1.0
199,2022-10-18,GOOG,103.94000244140624,104.22000122070312,100.6500015258789,101.38999938964844,21610500.0,0.0,0.0,0.6100006103515625,0.0,0.6100006103515625,56.20846929072483,95.2699966430664,104.22000122070312,68.37988398211569,-31.620116017884314,-1.8576324912511382,-2.465750419875971,-0.008119759549431338,-338409000.0,1.0
200,2022-10-19,GOOG,100.6999969482422,101.65899658203124,99.63500213623048,100.29000091552734,21573700.0,0.0,0.0,-1.0999984741210938,1.0999984741210938,0.0,50.84533267024508,95.2699966430664,104.22000122070312,56.089404523930284,-43.910595476069716,-1.6913098078760385,-2.310862297475985,-0.019072740502601215,-359982700.0,-1.0
201,2022-10-20,GOOG,100.81999969482422,103.0,99.97000122070312,100.52999877929688,25125100.0,0.0,0.0,0.23999786376953125,0.0,0.23999786376953125,51.998351641672265,95.2699966430664,104.22000122070312,58.77094352972265,-41.22905647027734,-1.5225807015427506,-2.1532059782893382,0.009641449105302735,-334857600.0,1.0
202,2022-10-21,GOOG,98.45999908447266,101.62000274658205,98.2300033569336,101.4800033569336,28988700.0,0.0,0.0,0.9500045776367188,0.0,0.9500045776367188,56.64342800237126,95.2699966430664,104.22000122070312,69.38551438715534,-30.614485612844653,-1.2972503561619249,-1.9820148538638556,0.028062043340619125,-305868900.0,1.0
203,2022-10-24,GOOG,102.08999633789062,103.0999984741211,100.3000030517578,102.97000122070312,24680800.0,0.0,0.0,1.4899978637695312,0.0,1.4899978637695312,63.104669405230695,95.2699966430664,104.22000122070312,86.03352669647386,-13.966473303526142,-0.9870657957325761,-1.7830250422375995,0.05017846013067628,-281188100.0,1.0
204,2022-10-25,GOOG,103.3000030517578,105.0999984741211,103.0199966430664,104.93000030517578,29910200.0,0.0,0.0,1.9599990844726562,0.0,1.9599990844726562,69.91066609228696,95.2699966430664,105.0999984741211,98.27061915280363,-1.7293808471963725,-0.5764419084458865,-1.5417084154792569,0.06744656203039079,-251277900.0,1.0
205,2022-10-26,GOOG,96.76000213623048,98.54000091552734,94.56999969482422,94.81999969482422,71504300.0,0.0,0.0,-10.110000610351562,10.110000610351562,0.0,33.32408688709296,94.56999969482422,105.0999984741211,2.3741693160641884,-97.62583068393582,-1.0546545761182813,-1.444297647607062,-0.049042216774124237,-322782200.0,-1.0
206,2022-10-27,GOOG,94.30999755859376,95.16999816894533,91.9000015258789,92.5999984741211,54036500.0,0.0,0.0,-2.220001220703125,2.220001220703125,0.0,29.422764980160963,91.9000015258789,105.0999984741211,5.303008409675462,-94.69699159032454,-1.5943978588988585,-1.4743176898654213,-0.047129057590780454,-376818700.0,-1.0
207,2022-10-28,GOOG,92.52999877929688,96.86000061035156,92.322998046875,96.58000183105467,35696900.0,0.0,0.0,3.9800033569335795,0.0,3.9800033569335795,43.18259463456532,91.9000015258789,105.0999984741211,35.45455596335567,-64.54544403664433,-1.6816107608358948,-1.5157763040595162,-0.04167490572648236,-341121800.0,1.0
208,2022-10-31,GOOG,95.77999877929688,96.3499984741211,94.37999725341795,94.66000366210938,29868700.0,0.0,0.0,-1.9199981689452983,1.9199981689452983,0.0,38.95514426921376,91.9000015258789,105.0999984741211,20.909111926711557,-79.09088807328844,-1.8839385341229757,-1.5894087500722083,-0.06637731302941674,-370990500.0,-1.0
209,2022-11-01,GOOG,95.58999633789062,96.16500091552734,90.43000030517578,90.5,43220600.0,0.0,0.0,-4.160003662109375,4.160003662109375,0.0,31.295728360444116,90.43000030517578,105.0999984741211,0.47716226013170204,-99.5228377398683,-2.35284017380809,-1.7420950348193847,-0.09761691919589577,-414211100.0,-1.0
210,2022-11-02,GOOG,90.91000366210938,91.3000030517578,87.01000213623047,87.06999969482422,43553600.0,0.0,0.0,-3.4300003051757812,3.4300003051757812,0.0,26.36408281220932,87.01000213623047,105.0999984741211,0.3316615297930236,-99.66833847020698,-2.96701849458924,-1.9870797267733558,-0.13389037349958277,-457764700.0,-1.0
211,2022-11-03,GOOG,86.34500122070312,86.55000305175781,83.44999694824219,83.48999786376953,48510400.0,0.0,0.0,-3.5800018310546875,3.5800018310546875,0.0,22.158842174755605,83.44999694824219,105.0999984741211,0.18476172151549014,-99.81523827848451,-3.699984328070343,-2.329660647032753,-0.17727635886932502,-506275100.0,-1.0
212,2022-11-04,GOOG,85.51000213623047,86.7300033569336,83.87999725341797,86.69999694824219,40173300.0,0.0,0.0,3.2099990844726562,0.0,3.2099990844726562,33.18494595834335,83.44999694824219,105.0999984741211,15.011546286106151,-84.98845371389385,-3.9760119591695826,-2.6589309094601195,-0.1580072261783143,-466101800.0,1.0
213,2022-11-07,GOOG,87.33999633789062,88.94000244140625,86.95999908447266,88.6500015258789,26899900.0,0.0,0.0,1.9500045776367188,0.0,1.9500045776367188,39.21963279140893,83.44999694824219,105.0999984741211,24.018495201586916,-75.98150479841308,-3.991406334881333,-2.9254259945443626,-0.1551510409982706,-439201900.0,1.0
214,2022-11-08,GOOG,89.16000366210938,90.40499877929688,87.6500015258789,88.91000366210938,30172000.0,0.0,0.0,0.26000213623046875,0.0,0.26000213623046875,40.05262280023935,83.44999694824219,105.0999984741211,25.219428771590042,-74.78057122840997,-3.9372404330189426,-3.127788882239279,-0.06232858101387906,-409029900.0,1.0
215,2022-11-09,GOOG,88.54499816894531,89.48999786376953,87.36000061035156,87.4000015258789,26743900.0,0.0,0.0,-1.5100021362304688,1.5100021362304688,0.0,36.68364956303872,83.44999694824219,105.0999984741211,18.24482355308455,-81.75517644691546,-3.970389927517644,-3.2963090912949524,-0.05615547552838707,-435773800.0,-1.0
216,2022-11-10,GOOG,92.33999633789062,94.5500030517578,91.6500015258789,94.16999816894533,42371200.0,0.0,0.0,6.7699966430664205,0.0,6.7699966430664205,55.88130081042594,83.44999694824219,105.0999984741211,49.51501369590757,-50.48498630409243,-3.411058460172711,-3.3192589650705044,-0.02495344394717569,-393402600.0,1.0
217,2022-11-11,GOOG,94.70999908447266,97.36000061035156,94.16000366210938,96.7300033569336,30569100.0,0.0,0.0,2.560005187988267,0.0,2.560005187988267,61.0359238019689,83.44999694824219,105.0999984741211,61.33951719503303,-38.66048280496697,-2.7297464111911864,-3.201356454294641,0.02186773309467771,-362833500.0,1.0
218,2022-11-14,GOOG,95.5,97.18000030517578,95.11299896240234,96.02999877929688,24170100.0,0.0,0.0,-0.7000045776367188,0.7000045776367188,0.0,58.86598944049138,83.44999694824219,98.54000091552734,83.36645807600776,-16.63354192399224,-2.220687517222956,-3.0052226668803046,0.06110495888725831,-387003600.0,-1.0
219,2022-11-15,GOOG,98.66999816894533,100.41999816894533,97.0199966430664,98.72000122070312,31831000.0,0.0,0.0,2.69000244140625,0.0,2.69000244140625,64.46729256336829,83.44999694824219,100.41999816894533,89.98234044810656,-10.017659551893441,-1.5819581407187115,-2.7205697616479863,0.13380040848411112,-355172600.0,1.0
220,2022-11-16,GOOG,98.0199966430664,99.8499984741211,97.9020004272461,98.98999786376952,24660200.0,0.0,0.0,0.26999664306639204,0.0,0.26999664306639204,65.01895622990213,83.44999694824219,100.41999816894533,91.57336356917152,-8.426636430828486,-1.0419629362423848,-2.3848483965668663,0.1856509809149991,-330512400.0,1.0
221,2022-11-17,GOOG,97.18000030517578,99.4800033569336,97.0999984741211,98.5,21818700.0,0.0,0.0,-0.48999786376951704,0.48999786376951704,0.0,62.97168618101224,83.44999694824219,100.41999816894533,88.68592792672897,-11.31407207327103,-0.6461036962700177,-2.0370994565074967,0.13610153941299585,-352331100.0,-1.0
222,2022-11-18,GOOG,99.01000213623048,99.16000366210938,96.73999786376952,97.8000030517578,24969900.0,0.0,0.0,-0.6999969482422017,0.6999969482422017,0.0,59.86458781320047,83.44999694824219,100.41999816894533,84.56101986609656,-15.438980133903438,-0.38443477366422485,-1.7065665199388422,0.10321490545274048,-377301000.0,-1.0
223,2022-11-21,GOOG,97.55999755859376,98.72000122070312,95.66999816894533,95.83000183105467,18696900.0,0.0,0.0,-1.970001220703125,1.970001220703125,0.0,51.59743363855943,83.44999694824219,100.41999816894533,72.95229223501217,-27.047707764987834,-0.3321935762853485,-1.4316919312081435,0.07783149121491251,-395997900.0,-1.0
224,2022-11-22,GOOG,96.16000366210938,97.5479965209961,94.41000366210938,97.33000183105467,18868900.0,0.0,0.0,1.5,0.0,1.5,56.83457968356532,83.44999694824219,100.41999816894533,81.79141947190371,-18.20858052809628,-0.16782006515059322,-1.1789175579966336,0.1136155621488808,-377129000.0,1.0
225,2022-11-23,GOOG,97.33999633789062,99.06900024414062,97.33999633789062,98.81999969482422,17568900.0,0.0,0.0,1.4899978637695455,0.0,1.4899978637695455,61.59705872581066,83.87999725341797,100.41999816894533,90.32649101839489,-9.673508981605119,0.08173530497288084,-0.9267869854027306,0.04937880021550578,-359560100.0,1.0
226,2022-11-25,GOOG,98.46499633789062,98.94000244140624,97.52999877929688,97.5999984741211,8567800.0,0.0,0.0,-1.220001220703125,1.220001220703125,0.0,55.78248978434466,86.95999908447266,100.41999816894533,79.04903501756283,-20.95096498243717,0.17900240520710042,-0.7056291072807644,0.008994056518092153,-368127900.0,-1.0
227,2022-11-28,GOOG,97.1999969482422,97.83000183105467,95.88999938964844,96.25,19974500.0,0.0,0.0,-1.3499984741210938,1.3499984741210938,0.0,49.78244254685523,87.36000061035156,100.41999816894533,68.07045215562559,-31.92954784437442,0.14547672571600856,-0.5354079406814098,0.00229096348536606,-388102400.0,-1.0
228,2022-11-29,GOOG,96.0,96.38999938964844,94.38999938964844,95.44000244140624,20220000.0,0.0,0.0,-0.8099975585937642,0.8099975585937642,0.0,46.3322856944193,87.36000061035156,100.41999816894533,61.86832573898803,-38.13167426101198,0.05293712475902623,-0.4177389275933226,-0.03322527085432225,-408322400.0,-1.0
229,2022-11-30,GOOG,95.12000274658205,101.4499969482422,94.66999816894533,101.4499969482422,39888100.0,0.0,0.0,6.009994506835966,0.0,6.009994506835966,66.31739657993111,91.6500015258789,101.4499969482422,100.0,-0.0,0.4592610684221654,-0.24233892839022494,0.02485098633761096,-368434300.0,1.0
230,2022-12-01,GOOG,101.4000015258789,102.58999633789062,100.66999816894533,101.27999877929688,21771500.0,0.0,0.0,-0.1699981689453267,0.1699981689453267,0.0,65.5210676312685,94.16000366210938,102.58999633789062,84.46027643230015,-15.539723567699848,0.7588111868159615,-0.042108905348987605,0.028223337860882047,-390205800.0,-1.0
231,2022-12-02,GOOG,99.37000274658205,101.1500015258789,99.16999816894533,100.83000183105467,18821500.0,0.0,0.0,-0.4499969482422017,0.4499969482422017,0.0,63.203052222759155,94.38999938964844,102.58999633789062,78.53664436773678,-21.46335563226322,0.9489568376438626,0.1561042432495825,0.03098158164364606,-409027300.0,-1.0
232,2022-12-05,GOOG,99.81500244140624,101.75,99.3550033569336,99.87000274658205,19955500.0,0.0,0.0,-0.9599990844726278,0.9599990844726278,0.0,58.139923528347765,94.38999938964844,102.58999633789062,66.829334102476,-33.170665897523996,1.0105359050201628,0.3269905756036986,0.04215799685206911,-428982800.0,-1.0
233,2022-12-06,GOOG,99.66999816894533,100.20999908447266,96.76000213623048,97.30999755859376,20877600.0,0.0,0.0,-2.5600051879882812,2.5600051879882812,0.0,46.64292182508065,94.38999938964844,102.58999633789062,35.60974702034834,-64.39025297965166,0.8430485991430459,0.4302021803115681,-0.00020553038204640384,-449860400.0,-1.0
234,2022-12-07,GOOG,96.7699966430664,97.30999755859376,95.0250015258789,95.1500015258789,26647900.0,0.0,0.0,-2.159996032714858,2.159996032714858,0.0,39.11298815269516,94.38999938964844,102.58999633789062,9.268322183868477,-90.73167781613152,0.5299115859146184,0.4501440614321781,-0.037138212712801044,-476508300.0,-1.0
235,2022-12-08,GOOG,95.69000244140624,95.87000274658205,93.8000030517578,93.9499969482422,25593200.0,0.0,0.0,-1.2000045776367045,1.2000045776367045,0.0,35.44492104785199,93.8000030517578,102.58999633789062,1.7064165079743023,-98.29358349202569,0.18281058095116975,0.3966773653359765,-0.037397557202285214,-502101500.0,-1.0
236,2022-12-09,GOOG,93.9000015258789,94.48999786376952,93.0199966430664,93.06999969482422,21885300.0,0.0,0.0,-0.879997253417983,0.879997253417983,0.0,32.83904855115891,93.0199966430664,102.58999633789062,0.5224979451656185,-99.47750205483437,-0.16141717260367727,0.2850584577480457,-0.03303896420961849,-523986800.0,-1.0
237,2022-12-12,GOOG,93.08999633789062,93.875,91.9000015258789,93.55999755859376,27380900.0,0.0,0.0,0.48999786376954546,0.0,0.48999786376954546,35.868282374198756,91.9000015258789,102.58999633789062,15.528501761755937,-84.47149823824405,-0.3901836212622811,0.15001004194598033,-0.019698290388945328,-496605900.0,1.0
238,2022-12-13,GOOG,98.06999969482422,99.8000030517578,95.37999725341795,95.8499984741211,34788500.0,0.0,0.0,2.2900009155273295,0.0,2.2900009155273295,48.41496849600057,91.9000015258789,102.58999633789062,36.95041033886947,-63.04958966113053,-0.3822919228655195,0.043549648983680335,-0.055199592336884096,-461817400.0,1.0
239,2022-12-14,GOOG,95.54000091552734,97.22000122070312,93.94000244140624,95.30999755859376,26452900.0,0.0,0.0,-0.5400009155273295,0.5400009155273295,0.0,45.968052749768354,91.9000015258789,102.58999633789062,31.898949369771874,-68.10105063022813,-0.41482936089595057,-0.048126152992245874,-0.058945510393543454,-488270300.0,-1.0
240,2022-12-15,GOOG,93.54000091552734,94.02999877929688,90.43000030517578,91.1999969482422,28298800.0,0.0,0.0,-4.1100006103515625,4.1100006103515625,0.0,31.837173996580702,90.43000030517578,102.58999633789062,6.332211301671871,-93.66778869832812,-0.763457549386672,-0.19119243227113117,-0.09550733618896479,-516569100.0,-1.0
241,2022-12-16,GOOG,91.1999969482422,91.75,90.01000213623047,90.86000061035156,48485500.0,0.0,0.0,-0.3399963378906392,0.3399963378906392,0.0,30.929629270899184,90.01000213623047,102.58999633789062,6.756747741655725,-93.24325225834428,-1.0550211363183024,-0.36395817308056555,-0.09021730137620165,-565054600.0,-1.0
242,2022-12-19,GOOG,90.87999725341795,91.1999969482422,88.92500305175781,89.1500015258789,23020500.0,0.0,0.0,-1.7099990844726562,1.7099990844726562,0.0,26.539339535506784,88.92500305175781,102.58999633789062,1.6465319038935893,-98.35346809610641,-1.4078412955156239,-0.5727347975675773,-0.08385568017100642,-588075100.0,-1.0
243,2022-12-20,GOOG,88.7300033569336,89.77999877929688,88.04000091552734,89.62999725341797,21976800.0,0.0,0.0,0.4799957275390625,0.0,0.4799957275390625,29.768145911198076,88.04000091552734,102.58999633789062,10.92781332045512,-89.07218667954487,-1.6299333134620326,-0.7841745007464684,-0.05801370660997418,-566098300.0,1.0
244,2022-12-21,GOOG,89.7300033569336,90.91500091552734,88.91000366210938,90.25,20336400.0,0.0,0.0,0.6200027465820312,0.0,0.6200027465820312,34.0860095851115,88.04000091552734,101.75,16.119615113436474,-83.88038488656353,-1.7359033843175808,-0.9745202774606911,-0.03938261914239938,-545761900.0,1.0
245,2022-12-22,GOOG,88.93000030517578,89.18000030517578,86.94000244140625,88.26000213623047,23656100.0,0.0,0.0,-1.9899978637695312,1.9899978637695312,0.0,27.764372516481572,86.94000244140625,101.75,8.912896100096024,-91.08710389990398,-1.9578922612833338,-1.17119467422522,-0.05168150396868698,-569418000.0,-1.0
246,2022-12-23,GOOG,87.62000274658203,90.0999984741211,87.62000274658203,89.80999755859375,17815000.0,0.0,0.0,1.5499954223632812,0.0,1.5499954223632812,38.084366214990354,86.94000244140625,100.20999908447266,21.627700401017634,-78.37229959898237,-1.985856650192929,-1.334127069418762,-0.04008123234132732,-551603000.0,1.0
247,2022-12-27,GOOG,89.30999755859375,89.5,87.53500366210938,87.93000030517578,15470900.0,0.0,0.0,-1.8799972534179688,1.8799972534179688,0.0,31.73852223498109,86.94000244140625,99.8000030517578,7.698272292247334,-92.30172770775266,-2.1351065168231287,-1.4943229588996354,-0.08262909019329467,-567073900.0,-1.0
248,2022-12-28,GOOG,87.5,88.5199966430664,86.37000274658203,86.45999908447266,17879600.0,0.0,0.0,-1.470001220703125,1.470001220703125,0.0,27.590752898104483,86.37000274658203,99.8000030517578,0.6701141909575494,-99.32988580904245,-2.3449735289180182,-1.664453072903312,-0.09285488092348748,-584953500.0,-1.0
249,2022-12-29,GOOG,87.02999877929688,89.36499786376953,86.98999786376953,88.94999694824219,18280700.0,0.0,0.0,2.4899978637695312,0.0,2.4899978637695312,42.32275003649473,86.37000274658203,99.8000030517578,19.210678652522862,-80.78932134747714,-2.284043598151044,-1.7883711779528588,-0.024671053457128278,-566672800.0,1.0
250,2022-12-30,GOOG,87.36499786376953,88.83000183105469,87.02999877929688,88.7300033569336,19190300.0,0.0,0.0,-0.21999359130859375,0.21999359130859375,0.0,41.462776792370335,86.37000274658203,99.8000030517578,17.572602805094842,-82.42739719490515,-2.2278268322677377,-1.876262308815835,-0.023442628649677832,-585863100.0,-1.0
515,2022-01-21,META,314.4763411554547,317.9726316245629,302.71882675259485,302.84869384765625,28710700.0,0.0,0.0,-13.37579345703125,13.37579345703125,0.0,20.336042259086526,302.71882675259485,342.7263539178677,0.3246066534552684,-99.67539334654472,-2.8442151286393482,-1.2848179582508825,-0.08625936092500464,-91537400.0,-1.0
516,2022-01-24,META,297.52430824604005,309.2019201602846,288.70368079829205,308.3827819824219,38878100.0,0.0,0.0,5.534088134765625,0.0,5.534088134765625,30.973882101124445,288.70368079829205,342.7263539178677,36.42748506829979,-63.572514931700205,-3.298411401336125,-1.6875366468679314,-0.05901187879022651,-52659300.0,1.0
517,2022-01-25,META,299.63210892409154,305.90545182024937,297.26459517097044,299.8318786621094,25108500.0,0.0,0.0,-8.5509033203125,8.5509033203125,0.0,25.017868221624667,288.70368079829205,338.8105458895365,22.208928544128444,-77.79107145587156,-4.120204748812114,-2.1740702672567678,-0.10234167621210111,-77767800.0,-1.0
518,2022-01-26,META,306.6846014838847,307.18407152024935,290.54172625035204,294.3177185058594,28348800.0,0.0,0.0,-5.51416015625,5.51416015625,0.0,21.886389465533668,288.70368079829205,338.8105458895365,11.204128810182343,-88.79587118981766,-5.037046657203973,-2.746665545246209,-0.11591556823046578,-106116600.0,-1.0
519,2022-01-27,META,297.4344173767479,301.3902116714853,293.9481261525267,294.3277282714844,21629900.0,0.0,0.0,0.010009765625,0.0,0.010009765625,21.90686354924304,288.70368079829205,336.6428240371336,11.731639518821373,-88.26836048117863,-5.676732346071844,-3.3326789054113366,-0.0975250866539693,-84486700.0,1.0
520,2022-01-28,META,295.306656430845,301.57999880462046,292.7194053269154,301.39019775390625,21871600.0,0.0,0.0,7.062469482421875,0.0,7.062469482421875,35.640121053008144,288.70368079829205,336.0134885049402,26.81582862115806,-73.18417137884194,-5.646240550762911,-3.7953912344816523,-0.09096118875879355,-62615100.0,1.0
521,2022-01-31,META,300.36129526562405,313.4574155374306,299.0027513927763,312.927978515625,21579500.0,0.0,0.0,11.53778076171875,0.0,11.53778076171875,51.663372511854305,288.70368079829205,336.0134885049402,51.203542968382976,-48.79645703161702,-4.8025216895481435,-3.9968173254949506,-0.015370137957325114,-41035600.0,1.0
522,2022-02-01,META,314.2265992155211,319.32119988415064,311.78918290323924,318.6618957519531,18023800.0,0.0,0.0,5.733917236328125,0.0,5.733917236328125,57.70192781635201,288.70368079829205,336.0134885049402,63.32347647536778,-36.67652352463222,-3.7137294043717475,-3.9401997412703103,-0.001846055313789785,-23011800.0,1.0
523,2022-02-02,META,327.47255242956174,327.6523543319466,316.534146089326,322.6576538085937,58458300.0,0.0,0.0,3.995758056640568,0.0,3.995758056640568,61.56295100704755,288.70368079829205,335.27426791152067,72.90862133163195,-27.091378668368044,-2.5585037684459166,-3.6638605467054317,0.020343669646644802,35446500.0,1.0
524,2022-02-03,META,244.39069236928975,247.73714784243376,235.50013146715224,237.50799560546875,188119900.0,0.0,0.0,-85.14965820312494,85.14965820312494,0.0,18.974742881054624,235.50013146715224,332.3773551398727,2.072586374997345,-97.92741362500266,-7.417135054941582,-4.414515448352662,-0.21575360755908102,-152673400.0,-1.0
525,2022-02-04,META,234.72096637628675,242.35286845117392,229.8661166766454,236.83871459960935,89342200.0,0.0,0.0,-0.6692810058594034,0.6692810058594034,0.0,18.85643788353522,229.8661166766454,327.6523543319466,7.1304491206037905,-92.86955087939621,-11.14919144344293,-5.761450647370717,-0.23199760674994696,-242015600.0,-1.0
526,2022-02-07,META,237.44806856106547,238.04743874294925,223.77257558654935,224.671630859375,88613800.0,0.0,0.0,-12.167083740234347,12.167083740234347,0.0,16.675550345178095,223.77257558654935,327.6523543319466,0.8654766920799634,-99.13452330792005,-14.765958173714694,-7.562352152639513,-0.25067463852779637,-330629400.0,-1.0
527,2022-02-08,META,220.61592803896136,225.53071152093744,215.920897356632,219.94662475585935,94729700.0,0.0,0.0,-4.725006103515653,4.725006103515653,0.0,15.853924332304615,215.920897356632,327.6523543319466,3.6030384890772296,-96.39696151092278,-17.740156079828523,-9.597912938077316,-0.25268982828337405,-425359100.0,-1.0
528,2022-02-09,META,223.96236873818623,233.122647681972,221.97448768232977,231.7541046142578,86563300.0,0.0,0.0,11.807479858398466,0.0,11.807479858398466,26.321318878922455,215.920897356632,327.6523543319466,14.170769527442866,-85.82923047255714,-19.01324003669106,-11.480978357800065,-0.21259846642620572,-338795800.0,1.0
529,2022-02-10,META,228.02806256082687,234.7509252150093,226.45971927591333,227.82827758789065,49310400.0,0.0,0.0,-3.925827026367159,3.925827026367159,0.0,25.122405509889376,215.920897356632,327.6523543319466,10.657142181444405,-89.3428578185556,-20.065009469794006,-13.197784580198855,-0.24407535717562057,-388106200.0,-1.0
530,2022-02-11,META,228.21786665101624,230.17578075145823,218.53813444392335,219.3173065185547,46156900.0,0.0,0.0,-8.510971069335966,8.510971069335966,0.0,22.55274672120038,215.920897356632,327.6523543319466,3.0397967178330783,-96.96020328216693,-21.265818416337737,-14.811391347426632,-0.29914446270069195,-434263100.0,-1.0
531,2022-02-14,META,219.07754768721537,220.76575887033653,214.55235031982545,217.46925354003903,38184000.0,0.0,0.0,-1.8480529785156534,1.8480529785156534,0.0,21.989229162307822,214.55235031982545,327.6523543319466,2.57904784857565,-97.42095215142434,-22.090649752742223,-16.26724302848975,-0.31755488673387733,-472447100.0,-1.0
532,2022-02-15,META,220.23632529496143,220.9155972472105,214.8320556901252,220.7657623291016,42685500.0,0.0,0.0,3.296508789062557,0.0,3.296508789062557,25.804900498939674,214.55235031982545,327.6523543319466,5.493732792980484,-94.5062672070195,-22.23782548846023,-17.46135952048385,-0.3157894761732081,-429761600.0,1.0
533,2022-02-16,META,212.18487352902437,217.2295241593353,212.1349234747408,216.31048583984372,45817500.0,0.0,0.0,-4.455276489257869,4.455276489257869,0.0,23.976112011768762,212.1349234747408,327.6523543319466,3.614659999030327,-96.38534000096968,-22.42352423399589,-18.453792463186257,-0.08924966804417322,-475579100.0,-1.0
534,2022-02-17,META,213.7931624375332,217.2694696845535,206.9404328069732,207.48985290527344,38747500.0,0.0,0.0,-8.820632934570284,8.820632934570284,0.0,20.63534611821035,206.9404328069732,327.6523543319466,0.4551498239439136,-99.54485017605609,-22.96280660504189,-19.355595291557385,-0.1239191900866039,-514326600.0,-1.0
535,2022-02-18,META,209.16807010681745,210.5266292731603,204.96252551517887,205.9414978027344,37128400.0,0.0,0.0,-1.548355102539034,1.548355102539034,0.0,20.06896218405899,204.96252551517887,327.6523543319466,0.7979245688064256,-99.20207543119358,-23.23479138409118,-20.131434510064146,-0.08336670270740165,-551455000.0,-1.0
536,2022-02-22,META,202.12553314374657,207.26008457102,199.8479509693212,201.8658142089844,39852400.0,0.0,0.0,-4.07568359375,4.07568359375,0.0,18.524676652645567,199.8479509693212,327.6523543319466,1.5788683226647695,-98.42113167733523,-23.484749568777772,-20.80209752180687,-0.08220544673938346,-591307400.0,-1.0
537,2022-02-23,META,203.94360906755128,206.72066125252053,197.840084608655,198.2396545410156,44481400.0,0.0,0.0,-3.626159667968807,3.626159667968807,0.0,17.168461953901158,197.840084608655,247.73714784243376,0.8007884762446493,-99.19921152375535,-23.682556903095247,-21.37818939806455,-0.14461211001645558,-635788800.0,-1.0
538,2022-02-24,META,190.85749629586323,208.1291794529085,190.0183902558962,207.3799743652344,49957200.0,0.0,0.0,9.140319824218807,0.0,9.140319824218807,31.709639908661188,190.0183902558962,242.35286845117392,33.174275750980506,-66.82572424901949,-22.874495427063977,-21.677450603864436,-0.08975313968551502,-585831600.0,1.0
539,2022-02-25,META,204.72279067229695,211.09603351680065,202.96464630547305,210.2569122314453,37627600.0,0.0,0.0,2.876937866210909,0.0,2.876937866210909,35.80260700107819,190.0183902558962,238.04743874294925,42.13808645616767,-57.86191354383232,-21.761069439273257,-21.694174370946204,-0.04131180722093564,-548204000.0,1.0
540,2022-02-28,META,207.45987990024625,212.92408365757623,206.61078993114856,210.80633544921875,34239800.0,0.0,0.0,0.5494232177734375,0.0,0.5494232177734375,36.639408606588454,190.0183902558962,234.7509252150093,46.47164577711361,-53.528354222886385,-20.59790877202539,-21.474921251162044,-0.030638437307154986,-513964200.0,1.0
541,2022-03-01,META,209.64754985967724,211.5255620890376,202.0056643393393,203.2743225097656,27094900.0,0.0,0.0,-7.532012939453153,7.532012939453153,0.0,30.37627609555298,190.0183902558962,234.7509252150093,29.633760451952302,-70.3662395480477,-20.026428156413232,-21.185222632212284,-0.07923076311652444,-541059100.0,-1.0
542,2022-03-02,META,204.56294727779687,208.9283105266018,201.8058781589647,207.8894195556641,29452100.0,0.0,0.0,4.615097045898494,0.0,4.615097045898494,37.88332172752054,190.0183902558962,234.7509252150093,39.95085303370926,-60.04914696629074,-18.995640691526376,-20.747306244075105,-0.03893045800107253,-511607000.0,1.0
543,2022-03-03,META,208.7984737490768,208.8584077190652,201.2065225364588,202.7548828125,27263500.0,0.0,0.0,-5.134536743164091,5.134536743164091,0.0,33.277279111437736,190.0183902558962,230.17578075145823,31.7164347569132,-68.2835652430868,-18.365542129072963,-20.27095342107468,-0.022820248925305875,-538870500.0,-1.0
544,2022-03-04,META,202.15551070408355,205.67178425524827,198.57930318350063,199.84796142578125,32130900.0,0.0,0.0,-2.90692138671875,2.90692138671875,0.0,30.828695306199663,190.0183902558962,220.9155972472105,31.813785539412322,-68.18621446058768,-17.885805507368445,-19.793923838333434,-0.02958867659974962,-571001400.0,-1.0
545,2022-03-07,META,200.57717544006692,200.6770755468484,187.08150021221624,187.27130126953125,38560600.0,0.0,0.0,-12.57666015625,12.57666015625,0.0,22.546768130753478,187.08150021221624,220.9155972472105,0.5609756841410589,-99.43902431585894,-18.27717614271532,-19.49057429920981,-0.07229809067296544,-609562000.0,-1.0
546,2022-03-08,META,187.65090160172156,196.4915122337211,185.91274036150173,190.0883026123047,37508100.0,0.0,0.0,2.8170013427734375,0.0,2.8170013427734375,27.57520683562842,185.91274036150173,217.2694696845535,13.31631946618012,-86.68368053381987,-18.156145844019676,-19.223688608171784,-0.04111867500770083,-572053900.0,1.0
547,2022-03-09,META,195.5325426004067,198.88898197939665,193.7144642839213,198.28961181640625,31894700.0,0.0,0.0,8.201309204101562,0.0,8.201309204101562,40.542376706493066,185.91274036150173,217.2694696845535,39.471181217250574,-60.528818782749426,-17.216880198328738,-18.822326926203175,-0.043834331529129966,-540159200.0,1.0
548,2022-03-10,META,194.6334945736175,196.071970824045,190.86750119429811,195.00311279296875,24853000.0,0.0,0.0,-3.2864990234375,3.2864990234375,0.0,37.44265436223205,185.91274036150173,212.92408365757623,33.653907293044924,-66.34609270695508,-16.539964524825507,-18.365854445927642,-0.0725483850998705,-565012200.0,-1.0
549,2022-03-11,META,192.43581542888404,193.3548384687252,186.4721419620164,187.41114807128903,34694500.0,0.0,0.0,-7.591964721679716,7.591964721679716,0.0,31.103983728041555,185.91274036150173,212.92408365757623,5.547327629592792,-94.45267237040721,-16.412303382965916,-17.975144233335296,-0.11097952691068624,-599706700.0,-1.0
550,2022-03-14,META,186.83177516342295,192.08619486869003,185.62306611695823,186.4322052001953,31010500.0,0.0,0.0,-0.9789428710937216,0.9789428710937216,0.0,30.33980419116466,185.62306611695823,212.92408365757623,2.9637689585498452,-97.03623104145015,-16.201061704364463,-17.62032772754113,-0.08285413081999649,-630717200.0,-1.0
551,2022-03-15,META,190.59776976505395,192.07619681127483,185.7129533975896,191.8264617919922,31721700.0,0.0,0.0,5.394256591796875,0.0,5.394256591796875,39.751123347086754,185.62306611695823,212.92408365757623,22.722214165844367,-77.27778583415564,-15.42859251357362,-17.18198068474763,-0.07726683636908671,-598995500.0,1.0
552,2022-03-16,META,194.49364123848665,203.5140694382437,194.3138393306404,203.4141845703125,40640300.0,0.0,0.0,11.587722778320312,0.0,11.587722778320312,54.86546370961292,185.62306611695823,212.92408365757623,65.16650314181491,-34.833496858185086,-13.739772097395587,-16.49353896727722,0.0032517182751263807,-558355200.0,1.0
553,2022-03-17,META,201.4862136409685,207.8194901702041,200.89684264452703,207.6197052001953,29499700.0,0.0,0.0,4.2055206298828125,0.0,4.2055206298828125,59.15623700735144,185.62306611695823,212.92408365757623,80.57076645773678,-19.429233542263226,-11.930183415970305,-15.580867857015837,0.03888828146641021,-528855500.0,1.0
554,2022-03-18,META,206.48091188533343,216.57021280982036,205.7816568765093,216.2605438232422,52128000.0,0.0,0.0,8.640838623046875,0.0,8.640838623046875,66.66842508059233,185.62306611695823,216.57021280982036,98.99936175166158,-1.0006382483384109,-9.697997302976717,-14.404293746208014,0.1547981049802607,-476727500.0,1.0
555,2022-03-21,META,214.2726581900749,214.48244232442497,207.40994436484132,211.26585388183597,30142300.0,0.0,0.0,-4.994689941406222,4.994689941406222,0.0,59.38376965736401,185.62306611695823,216.57021280982036,82.85994188534406,-17.140058114655947,-8.231390000641682,-13.169712997094747,0.11140901874811315,-506869800.0,-1.0
556,2022-03-22,META,211.1459619246178,219.22739883630052,209.95722077881769,216.4203643798828,31998800.0,0.0,0.0,5.154510498046847,0.0,5.154510498046847,64.0599790092879,185.62306611695823,219.22739883630052,91.64680792842522,-8.35319207157478,-6.582921725348513,-11.8523547427455,0.0914357156554606,-474871000.0,1.0
557,2022-03-23,META,213.10389755524497,216.57022098985925,211.93513944436188,213.2337646484375,23717300.0,0.0,0.0,-3.1865997314453125,3.1865997314453125,0.0,59.19824537733864,185.62306611695823,219.22739883630052,82.16410295088778,-17.835897049112216,-5.467489287119804,-10.575381651620363,0.09348902996653141,-498588300.0,-1.0
558,2022-03-24,META,214.7721167998866,220.43610521382087,214.5623326767264,219.3372802734375,31502300.0,0.0,0.0,6.103515625,0.0,6.103515625,65.05884528783335,185.62306611695823,220.43610521382087,96.84363971405648,-3.1563602859435296,-4.050038360863567,-9.270312993469004,0.17035343164326666,-467086000.0,1.0
559,2022-03-25,META,220.2762755698854,225.26099214731644,218.6579974884155,221.58489990234372,40039000.0,0.0,0.0,2.2476196289062216,0.0,2.2476196289062216,67.0686917459293,185.62306611695823,225.26099214731644,90.72582091667145,-9.274179083328542,-2.716062226044585,-7.95946283998412,0.1885548404279218,-427047000.0,1.0
560,2022-03-28,META,221.894568082765,223.80253207899077,219.30730165346029,223.3530120849609,26224100.0,0.0,0.0,1.7681121826171875,0.0,1.7681121826171875,68.70274706311812,185.62306611695823,225.26099214731644,95.18647857384306,-4.813521426156946,-1.5004248372542008,-6.667655239438136,0.1643493290678253,-400822900.0,1.0
561,2022-03-29,META,225.83040240000065,230.64528589818943,225.05121507575743,229.6163787841797,31417900.0,0.0,0.0,6.263366699218778,0.0,6.263366699218778,73.98003113009233,185.62306611695823,230.64528589818943,97.71466818160158,-2.285331818398412,-0.035947072230442245,-5.341313605996597,0.12881203082870596,-369405000.0,1.0
562,2022-03-30,META,228.6673793039556,230.90499534679597,226.46971415790188,227.60850524902344,25588000.0,0.0,0.0,-2.00787353515625,2.00787353515625,0.0,69.63673843384088,185.62306611695823,230.90499534679597,92.72007585842795,-7.279924141572061,0.9528958882844734,-4.0824717071403835,0.09627602558029902,-394993000.0,-1.0
563,2022-03-31,META,228.20787036583656,228.2478365070273,222.0244285029212,222.12432861328125,24192300.0,0.0,0.0,-5.4841766357421875,5.4841766357421875,0.0,58.76400035723484,185.62306611695823,230.90499534679597,80.60889435839485,-19.391105641605154,1.2826293427853273,-3.009451497155241,0.027114445780880736,-419185300.0,-1.0
564,2022-04-01,META,224.31200924840297,227.03911153547216,222.46396391078724,224.6116943359375,19544800.0,0.0,0.0,2.48736572265625,0.0,2.48736572265625,61.878886651541336,185.7129533975896,230.90499534679597,86.0743158763841,-13.9256841236159,1.7232839087292007,-2.0629044159783527,0.06317083527168599,-399640500.0,1.0
565,2022-04-04,META,225.7404850597549,234.10162426654648,225.62061712245583,233.64210510253903,28054800.0,0.0,0.0,9.030410766601534,0.0,9.030410766601534,71.04211127228689,194.3138393306404,234.10162426654648,98.84507477672436,-1.1549252232756435,2.7643488398633735,-1.0974537648100071,0.07957541690682524,-371585700.0,1.0
566,2022-04-05,META,233.8319001070111,236.6089523616814,230.77514584414496,231.59426879882807,29727200.0,0.0,0.0,-2.047836303710966,2.047836303710966,0.0,66.8382947119499,200.89684264452703,236.6089523616814,85.95803047601942,-14.041969523980574,3.386053604967941,-0.2007522908544172,0.08610505086125486,-401312900.0,-1.0
567,2022-04-06,META,226.6694982902843,228.7472954956914,221.17532782412457,223.06332397460935,28995100.0,0.0,0.0,-8.530944824218722,8.530944824218722,0.0,52.03725886323023,205.7816568765093,236.6089523616814,56.0596277620673,-43.9403722379327,3.157886898497196,0.47097554701590566,0.016987735493604994,-430308000.0,-1.0
568,2022-04-07,META,223.69265640207155,225.28098279605464,218.3283527718337,222.7136993408203,21037200.0,0.0,0.0,-0.3496246337890341,0.3496246337890341,0.0,51.49798449355722,207.40994436484132,236.6089523616814,52.41190035509141,-47.58809964490858,2.915377673132298,0.9598559722391844,0.005094207407517759,-451345200.0,-1.0
569,2022-04-08,META,222.1443104064553,224.8913957567757,219.79679501004392,222.0943603515625,18375700.0,0.0,0.0,-0.6193389892578125,0.6193389892578125,0.0,50.42977435240869,209.95722077881769,236.6089523616814,45.539778663194426,-54.46022133680558,2.6429792376318915,1.296480625317726,-0.005635257486116374,-469720900.0,-1.0
570,2022-04-11,META,218.18848957465303,220.37617077995017,214.99188437991987,216.23057556152344,20516600.0,0.0,0.0,-5.8637847900390625,5.8637847900390625,0.0,41.11339238578131,211.93513944436188,236.6089523616814,17.40888662630016,-82.59111337369984,1.9338145906510817,1.4239474183843972,-0.05829637804382326,-490237500.0,-1.0
571,2022-04-12,META,220.00658108914112,221.79467722622925,212.90411611088945,213.9130401611328,20128800.0,0.0,0.0,-2.317535400390625,2.317535400390625,0.0,37.918829479316564,212.90411611088945,236.6089523616814,4.256194978818547,-95.74380502118144,1.1720916041541614,1.3735762555383502,-0.0601711481427577,-510366300.0,-1.0
572,2022-04-13,META,211.59550758420707,216.3804241438258,211.1060214286977,214.76214599609372,19231800.0,0.0,0.0,0.8491058349609091,0.0,0.8491058349609091,39.89322832941279,211.1060214286977,236.6089523616814,14.336095631531744,-85.66390436846825,0.6294343846883237,1.224747881368345,-0.03314442259949424,-491134500.0,1.0
573,2022-04-14,META,214.66224434243685,214.76214445267732,209.77742770696503,209.9572296142578,18379500.0,0.0,0.0,-4.804916381835909,4.804916381835909,0.0,33.033570851602235,209.77742770696503,236.6089523616814,0.670114388230187,-99.32988561176981,-0.18478211063509775,0.9428418829676565,-0.06524355183288866,-509514000.0,-1.0
574,2022-04-18,META,209.777427432069,213.153849951232,208.0792322585232,210.54661560058597,16580800.0,0.0,0.0,0.5893859863281534,0.0,0.5893859863281534,34.62460482463672,208.0792322585232,236.6089523616814,8.648466697679329,-91.35153330232068,-0.7737074113340157,0.599532024107322,-0.09884986052414269,-492933200.0,1.0
575,2022-04-19,META,210.29686970775435,218.1984741485847,208.7784765196788,217.0796661376953,20089900.0,0.0,0.0,6.533050537109347,0.0,6.533050537109347,49.86045838213023,208.0792322585232,236.6089523616814,31.547571608232417,-68.45242839176758,-0.7067485664921094,0.3382759059874357,-0.06267254684847456,-472843300.0,1.0
576,2022-04-20,META,213.3836034213357,213.9330235455877,198.70917035987355,200.20758056640625,43036500.0,0.0,0.0,-16.872085571289062,16.872085571289062,0.0,29.4254107344275,198.70917035987355,236.6089523616814,3.9536116763447917,-96.04638832365521,-1.9882597490775993,-0.12703122502557146,-0.10246302709451549,-515879800.0,-1.0
577,2022-04-21,META,201.3863244476076,202.7548674674917,185.38330023931803,187.87066650390625,49954100.0,0.0,0.0,-12.3369140625,12.3369140625,0.0,21.86488155563427,185.38330023931803,236.6089523616814,4.855704440124285,-95.14429555987572,-3.9510941561076436,-0.8918438112419862,-0.15644764080539797,-565833900.0,-1.0
578,2022-04-22,META,190.16823105352452,192.5157464978332,183.0757651499208,183.9148712158203,36426800.0,0.0,0.0,-3.9557952880859375,3.9557952880859375,0.0,19.966806245892315,183.0757651499208,236.6089523616814,1.5674502296682964,-98.4325497703317,-5.7586114561561885,-1.865197340224827,-0.1719066124655586,-602260700.0,-1.0
579,2022-04-25,META,182.53631463071252,186.98159489143785,181.46745668251413,186.79180908203125,29281100.0,0.0,0.0,2.8769378662109375,0.0,2.8769378662109375,25.40110237984645,181.46745668251413,236.6089523616814,9.655799745614612,-90.34420025438538,-6.880092592547129,-2.8681763906892876,-0.1361452532928955,-572979600.0,1.0
580,2022-04-26,META,186.4321969597802,186.9916009806197,179.3097491225669,180.7582092285156,31747400.0,0.0,0.0,-6.033599853515653,6.033599853515653,0.0,21.816420803940545,179.3097491225669,228.7472954956914,2.929878629122495,-97.0701213708775,-8.160578096751664,-3.926656731901764,-0.1549920982266575,-604727000.0,-1.0
581,2022-04-27,META,174.24511900966098,181.01794709289857,168.82088143733174,174.7645721435547,71062900.0,0.0,0.0,-5.993637084960909,5.993637084960909,0.0,18.778835268295637,168.82088143733174,225.28098279605464,10.527240587931871,-89.47275941206813,-9.547937401589053,-5.050912865839223,-0.1862412655034027,-675789900.0,-1.0
582,2022-04-28,META,202.7049283196297,208.30898303013493,192.69554399999976,205.51194763183597,100890600.0,0.0,0.0,30.74737548828128,0.0,30.74737548828128,55.474711938399494,168.82088143733174,224.8913957567757,65.43736336261966,-34.562636637380336,-8.077722001722663,-5.656274693015911,-0.021172321575155584,-574899300.0,1.0
583,2022-04-29,META,204.2432990597284,212.25478766770576,199.68811941092648,200.2575225830078,49193400.0,0.0,0.0,-5.254425048828153,5.254425048828153,0.0,50.93690836376178,168.82088143733174,221.79467722622925,59.34375794204407,-40.656242057955936,-7.2522394608838,-5.97546764658949,-0.04886847973418351,-624092700.0,-1.0
584,2022-05-02,META,200.95678432943805,211.65543983948064,200.77698242230932,210.9062347412109,49915300.0,0.0,0.0,10.648712158203097,0.0,10.648712158203097,58.8148244701632,168.82088143733174,221.79467722622925,79.44560641187734,-20.554393588122664,-5.674697168843011,-5.915313551040194,-0.028438552105421788,-574177400.0,1.0
585,2022-05-03,META,210.22694015320155,214.67222053184707,207.8694409169534,211.8052673339844,41556300.0,0.0,0.0,0.8990325927734943,0.0,0.8990325927734943,59.449107530199086,168.82088143733174,218.1984741485847,87.0524129193862,-12.9475870806138,-4.302456472648032,-5.592742135361762,0.05792830988101039,-532621100.0,1.0
586,2022-05-04,META,210.4267319781016,224.0622738781258,206.7406557076186,223.1732177734375,41375900.0,0.0,0.0,11.367950439453097,0.0,11.367950439453097,66.88903457560819,168.82088143733174,224.0622738781258,98.39059794584077,-1.6094020541592418,-2.272686357703037,-4.928730979830018,0.18790879878417432,-491245200.0,1.0
587,2022-05-05,META,218.50817038570932,219.9366474607897,205.94150167161104,208.0592498779297,41129200.0,0.0,0.0,-15.113967895507812,15.113967895507812,0.0,52.19763114505791,168.82088143733174,224.0622738781258,71.0307374721815,-28.9692625278185,-1.860708862491549,-4.3151265563623245,0.13128018687393928,-532374400.0,-1.0
588,2022-05-06,META,207.1202396541925,209.15808602336213,200.8069460575668,203.5540313720703,34747200.0,0.0,0.0,-4.505218505859375,4.505218505859375,0.0,48.53142664659144,168.82088143733174,224.0622738781258,62.875225261500134,-37.12477473849987,-1.875708612560942,-3.827242967602048,0.08973745889830642,-567121600.0,-1.0
589,2022-05-09,META,199.6281868933305,202.35530435423203,195.3727075340469,196.0020446777344,36303200.0,0.0,0.0,-7.551986694335909,7.551986694335909,0.0,42.726973773834274,168.82088143733174,224.0622738781258,49.20434123657284,-50.79565876342716,-2.467878157259804,-3.5553700055335993,0.08433274214366371,-603424800.0,-1.0
590,2022-05-10,META,199.2985351895107,202.7448907515309,193.9841817483169,197.4405059814453,34452500.0,0.0,0.0,1.438461303710909,0.0,1.438461303710909,44.19388849771857,168.82088143733174,224.0622738781258,51.80829678539903,-48.19170321460097,-2.7890581460665373,-3.4021076336401874,0.1297513195023543,-568972300.0,1.0
591,2022-05-11,META,196.1219145822161,200.4573110225389,188.07045969515485,188.5399627685547,31153400.0,0.0,0.0,-8.900543212890625,8.900543212890625,0.0,37.36186275941664,168.82088143733174,224.0622738781258,35.696206159823404,-64.30379384017661,-3.718270597011127,-3.465340226314376,-0.0825839327535629,-600125700.0,-1.0
592,2022-05-12,META,186.86173024913063,197.84008729340903,184.5841480700126,191.0373077392578,38262200.0,0.0,0.0,2.497344970703125,0.0,2.497344970703125,40.347426804523124,168.82088143733174,224.0622738781258,40.21699186119705,-59.78300813880294,-4.204848509706409,-3.613241882992783,-0.046041790215037626,-561863500.0,1.0
593,2022-05-13,META,192.37589315076397,199.6781431034774,191.0772679259079,198.40948486328125,24549800.0,0.0,0.0,7.3721771240234375,0.0,7.3721771240234375,48.67934303979199,168.82088143733174,224.0622738781258,53.562377989768486,-46.437622010231514,-3.950507776720883,-3.6806950617384033,-0.05925263372732248,-537313700.0,1.0
594,2022-05-16,META,196.84115124574123,205.1523250145863,195.72232796028052,199.82797241210935,27112600.0,0.0,0.0,1.4184875488280966,0.0,1.4184875488280966,50.22290109371884,168.82088143733174,224.0622738781258,56.130176313006594,-43.869823686993406,-3.593140718009778,-3.6631841929926785,-0.056548616909459115,-510201100.0,1.0
595,2022-05-17,META,201.90577285823605,205.24224445468596,198.14976348170072,202.40524291992188,24872700.0,0.0,0.0,2.5772705078125284,0.0,2.5772705078125284,53.17538384887017,184.5841480700126,224.0622738781258,45.14169425501664,-54.85830574498336,-3.066746332873805,-3.543896620968904,-0.09305764849704767,-485328400.0,1.0
596,2022-05-18,META,199.78802475600344,200.78696487978343,191.426900797602,192.0362548828125,23960000.0,0.0,0.0,-10.368988037109375,10.368988037109375,0.0,41.694800324660235,184.5841480700126,224.0622738781258,18.876546594490094,-81.1234534055099,-3.4460227917283532,-3.524321855120794,-0.07701169260447693,-509288400.0,-1.0
597,2022-05-19,META,190.99734880286024,195.0830102548423,189.39905374883708,191.08724975585935,24446900.0,0.0,0.0,-0.9490051269531534,0.9490051269531534,0.0,40.765353320813595,184.5841480700126,224.0622738781258,16.472670758119662,-83.52732924188034,-3.779560525918896,-3.5753695892804145,-0.06124556478777521,-533735300.0,-1.0
598,2022-05-20,META,194.7633617214404,197.70024819306403,187.67088057918448,193.3348693847656,31465600.0,0.0,0.0,2.24761962890625,0.0,2.24761962890625,44.16660621670619,184.5841480700126,224.0622738781258,22.165999868602253,-77.83400013139776,-3.8185998815674225,-3.6240156477378163,-0.013607895251063096,-502269700.0,1.0
599,2022-05-23,META,194.98312739891824,196.78122269052875,191.0373169140004,196.0220184326172,25059200.0,0.0,0.0,2.687149047851591,0.0,2.687149047851591,48.26456926559735,184.5841480700126,224.0622738781258,28.972678232495987,-71.02732176750402,-3.591411880848426,-3.6174948943599388,-0.007184379627559467,-477210500.0,1.0
600,2022-05-24,META,180.35863810235912,183.4853102503599,175.92334161956916,181.08786010742188,50406300.0,0.0,0.0,-14.934158325195312,14.934158325195312,0.0,32.818217957770315,175.92334161956916,219.9366474607897,11.733993593855208,-88.2660064061448,-4.563271471924139,-3.8066502098727795,-0.03952532159073752,-527616800.0,-1.0
601,2022-05-25,META,180.20878984813135,185.25344045498696,179.1299479422281,183.6351623535156,28030200.0,0.0,0.0,2.5473022460937216,0.0,2.5473022460937216,36.7990056732158,175.92334161956916,209.15808602336213,23.20409220016843,-76.79590779983158,-5.069571260831054,-4.059234420064435,-0.038747119467602786,-499586600.0,1.0
602,2022-05-26,META,182.68616931678451,192.6256202061961,182.06681609336133,191.4268951416016,23056500.0,0.0,0.0,7.791732788085994,0.0,7.791732788085994,47.73024581287893,175.92334161956916,205.24224445468596,52.87903714958598,-47.12096285041401,-4.787146551773617,-4.204816846406271,-0.03519282219038655,-476530100.0,1.0
603,2022-05-27,META,191.1571787980744,195.12297222801797,189.5988346755748,194.92318725585935,22562700.0,0.0,0.0,3.4962921142577557,0.0,3.4962921142577557,52.02630504415128,175.92334161956916,205.24224445468596,64.80408132303323,-35.19591867696676,-4.232511548848009,-4.210355786894619,-0.02454503789957274,-453967400.0,1.0
604,2022-05-31,META,194.6834438554816,197.3905783497063,191.8064913660645,193.4347686767578,26131100.0,0.0,0.0,-1.488418579101534,1.488418579101534,0.0,50.00738452453199,175.92334161956916,205.24224445468596,59.72742962337012,-40.27257037662988,-3.868428427171949,-4.141970314950084,-0.044319376878557804,-480098500.0,-1.0
605,2022-06-01,META,196.301717337045,199.31852076496773,184.80392205237183,188.4400634765625,36623500.0,0.0,0.0,-4.9947052001953125,4.9947052001953125,0.0,43.475042198215704,175.92334161956916,205.24224445468596,42.691644797844894,-57.308355202155106,-3.9374067697606563,-4.101057605912199,-0.01872662747169551,-516722000.0,-1.0
606,2022-06-02,META,188.25026074989617,200.7270282157059,187.53102265102356,198.64923095703125,31951600.0,0.0,0.0,10.20916748046875,0.0,10.20916748046875,56.787835538360696,175.92334161956916,205.24224445468596,77.51275504839865,-22.487244951601355,-3.1324040800853368,-3.9073269007468263,0.03957344726470957,-484770400.0,1.0
607,2022-06-03,META,195.77227473036533,196.40161186521712,189.5788492158237,190.57778930664065,19465000.0,0.0,0.0,-8.071441650390597,8.071441650390597,0.0,46.74468693279043,175.92334161956916,205.24224445468596,49.98293343200786,-50.01706656799214,-3.109712084178625,-3.7478039374331864,-0.01426064572261887,-504235400.0,-1.0
608,2022-06-06,META,193.78439422221575,196.7112813796668,188.20030751525445,194.0441131591797,30574200.0,0.0,0.0,3.466323852539034,0.0,3.466323852539034,51.03570197034487,175.92334161956916,205.24224445468596,61.805762792413645,-38.194237207586355,-2.780046029650947,-3.5542523558767383,-0.01009021991127701,-473661200.0,1.0
609,2022-06-07,META,191.72656851446376,196.32169912994013,191.28704766867264,195.442626953125,18828700.0,0.0,0.0,1.3985137939453125,0.0,1.3985137939453125,52.80593329671681,175.92334161956916,200.78696487978343,78.50539372027,-21.494606279730004,-2.3785419071516003,-3.3191102661317107,0.07926962545798388,-454832500.0,1.0
610,2022-06-08,META,194.46366638409845,201.815866089962,194.2039474468477,196.43157958984372,22267200.0,0.0,0.0,0.9889526367187216,0.0,0.9889526367187216,54.15821948333227,175.92334161956916,201.815866089962,79.20524703462189,-20.794752965378105,-1.957993046440663,-3.0468868221935015,0.06968391604486812,-432565300.0,1.0
611,2022-06-09,META,194.07408037066267,199.2385988309284,183.485309270246,183.8049774169922,23501600.0,0.0,0.0,-12.626602172851534,12.626602172851534,0.0,38.082626168325675,175.92334161956916,201.815866089962,30.439812102660742,-69.56018789733926,-2.613243369210977,-2.960158131596997,-0.03981633677426233,-456066900.0,-1.0
612,2022-06-10,META,182.84599515868484,182.90594437043703,174.83450627016524,175.38392639160156,27450800.0,0.0,0.0,-8.421051025390625,8.421051025390625,0.0,31.001357762195042,174.83450627016524,201.815866089962,2.036295150080638,-97.96370484991937,-3.768476611721809,-3.12182182762196,-0.10024082377952415,-483517700.0,-1.0
613,2022-06-13,META,170.4091842464364,172.39708048898234,163.8561397736271,164.0858917236328,31749300.0,0.0,0.0,-11.29803466796875,11.29803466796875,0.0,24.072150308261755,163.8561397736271,201.815866089962,0.6052518611201191,-99.39474813887989,-5.531741754937798,-3.603805813085128,-0.15172493111705732,-515267000.0,-1.0
614,2022-06-14,META,165.85402278701966,166.57326087497455,161.1889743715391,163.55645751953125,27244300.0,0.0,0.0,-0.5294342041015625,0.5294342041015625,0.0,23.784703435086172,161.1889743715391,201.815866089962,5.827379471707346,-94.17262052829265,-6.892400622662109,-4.261524775000525,-0.13205050719018774,-542511300.0,-1.0
615,2022-06-15,META,167.0227865445414,171.97753629185254,163.80619810928474,169.17051696777344,30008300.0,0.0,0.0,5.6140594482421875,0.0,5.6140594482421875,33.50041387810131,161.1889743715391,201.815866089962,19.6459592615474,-80.3540407384526,-7.432113351218987,-4.895642490244217,-0.14839581229304732,-512503000.0,1.0
616,2022-06-16,META,163.5464788681804,164.905038051073,159.4408343350916,160.69949340820312,26944100.0,0.0,0.0,-8.471023559570312,8.471023559570312,0.0,27.415718502017,159.4408343350916,201.815866089962,2.9702846723338503,-97.02971532766615,-8.445927422487188,-5.605699476692812,-0.15677742934861727,-539447100.0,-1.0
617,2022-06-17,META,161.50862268494694,165.72415098628295,159.73051058543922,163.5664520263672,31374200.0,0.0,0.0,2.8669586181640625,0.0,2.8669586181640625,32.22305062375101,159.4408343350916,201.815866089962,9.73596365695089,-90.26403634304911,-8.915298031873334,-6.267619187728918,-0.15706563129699713,-508072900.0,1.0
618,2022-06-21,META,165.7541225978725,167.5821848002958,155.80468779048013,156.883544921875,50724900.0,0.0,0.0,-6.6829071044921875,6.6829071044921875,0.0,27.35085841553844,155.80468779048013,201.815866089962,2.3447717951770404,-97.65522820482296,-9.714485837439042,-6.956992517670943,-0.19729105483471632,-558797800.0,-1.0
619,2022-06-22,META,158.21214709209156,160.61958128833666,155.27526058893076,155.68482971191406,47267800.0,0.0,0.0,-1.1987152099609375,1.1987152099609375,0.0,26.52092189772594,155.27526058893076,201.815866089962,0.880025342545714,-99.11997465745429,-10.32553487301729,-7.630700988740213,-0.2074348226645143,-606065600.0,-1.0
620,2022-06-23,META,156.10437414578536,159.5806814358929,154.0865108700249,158.5817413330078,40499200.0,0.0,0.0,2.89691162109375,0.0,2.89691162109375,32.25323144414173,154.0865108700249,201.815866089962,9.41816716833668,-90.58183283166332,-10.455534535173229,-8.195667698026817,-0.13722825376355974,-565566400.0,1.0
621,2022-06-24,META,161.5585866211284,170.06956098969064,161.1290496719425,169.9796600341797,68736000.0,0.0,0.0,11.397918701171875,0.0,11.397918701171875,49.971510632908675,154.0865108700249,201.815866089962,33.298478663537516,-66.70152133646248,-9.529079523075069,-8.462350063036467,-0.030813920457882227,-496830400.0,1.0
622,2022-06-27,META,171.13842598956154,171.5679629179658,167.83192144044523,169.31036376953125,29174600.0,0.0,0.0,-0.6692962646484375,0.6692962646484375,0.0,49.10141356718776,154.0865108700249,201.815866089962,31.896204818512132,-68.10379518148787,-8.748016945168047,-8.519483439462784,0.03183986137393169,-526005000.0,-1.0
623,2022-06-28,META,169.71991835162186,171.11844364921134,160.43977144961423,160.5096893310547,27744500.0,0.0,0.0,-8.800674438476562,8.800674438476562,0.0,38.84069680635704,154.0865108700249,201.815866089962,13.457501010503375,-86.54249898949662,-8.738373777099895,-8.563261506990207,-0.01862823537928937,-553749500.0,-1.0
624,2022-06-29,META,163.39664763253296,166.15371695886307,160.15009214541888,163.76625061035156,28595200.0,0.0,0.0,3.256561279296875,0.0,3.256561279296875,43.85050146544622,154.0865108700249,199.2385988309284,21.438077788801692,-78.56192221119831,-8.371470832984926,-8.52490337218915,-0.03194567501647683,-525154300.0,1.0
625,2022-06-30,META,161.9781262697551,165.05486351477865,158.32201719757518,161.07908630371094,35250600.0,0.0,0.0,-2.687164306640625,2.687164306640625,0.0,40.67800746538015,154.0865108700249,182.90594437043703,24.26340348982236,-75.73659651017765,-8.202955513952588,-8.460513800541838,0.0023621287625568144,-560404900.0,-1.0
626,2022-07-01,META,160.14008408708798,160.44975307751918,154.83571462488626,159.86038208007812,31423900.0,0.0,0.0,-1.2187042236328125,1.2187042236328125,0.0,39.19412593348672,154.0865108700249,172.39708048898234,31.532996133967178,-68.46700386603281,-8.074658612748664,-8.383342762983203,-0.022657885528333366,-591828800.0,-1.0
627,2022-07-05,META,157.9723831852602,168.07166797459743,156.85357517652852,168.01173400878906,28618600.0,0.0,0.0,8.151351928710938,0.0,8.151351928710938,52.55198460766396,154.0865108700249,171.97753629185254,77.8335663297137,-22.1664336702863,-7.231908230820665,-8.153055856550695,0.07093279981948197,-563210200.0,1.0
628,2022-07-06,META,168.0217292882176,171.40813576900965,165.28464304704374,169.59007263183594,23085900.0,0.0,0.0,1.578338623046875,0.0,1.578338623046875,54.77181072407393,154.0865108700249,171.97753629185254,86.65552362860196,-13.34447637139805,-6.363317850829958,-7.795108255406548,0.08931662092994386,-540124300.0,1.0
629,2022-07-07,META,169.2704058186061,172.5369443857157,167.60217759278888,172.00750732421875,24083400.0,0.0,0.0,2.4174346923828125,0.0,2.4174346923828125,58.22573046929177,154.0865108700249,172.5369443857157,97.13048985517487,-2.869510144825131,-5.4174473785546695,-7.319576080036174,0.08466148674088525,-516040900.0,1.0
630,2022-07-08,META,169.7998430316688,172.21727637413397,167.97178072156717,170.6988983154297,19249200.0,0.0,0.0,-1.3086090087890625,1.3086090087890625,0.0,55.574883457866015,154.0865108700249,172.5369443857157,90.03792475270082,-9.962075247299182,-4.719029191787371,-6.799466702386414,0.00423131968322199,-535290100.0,-1.0
631,2022-07-11,META,166.89292836459063,167.31248137380925,161.7383938354202,162.70736694335938,21885600.0,0.0,0.0,-7.9915313720703125,7.9915313720703125,0.0,42.07660415362342,154.0865108700249,172.5369443857157,46.724409299125846,-53.275590700874154,-4.75553161141616,-6.390679684192363,-0.03899936589327757,-557175700.0,-1.0
632,2022-07-12,META,164.6253314788325,165.73415559920247,161.92819625816986,163.09695434570312,16639700.0,0.0,0.0,0.38958740234375,0.0,0.38958740234375,42.85730273289898,154.0865108700249,172.5369443857157,48.83594452138733,-51.16405547861267,-4.698858932964043,-6.052315533946699,0.016119058141793152,-540536000.0,1.0
633,2022-07-13,META,159.99025423592747,164.80513771701277,159.4408341181126,163.3167266845703,16555100.0,0.0,0.0,0.2197723388671875,0.0,0.2197723388671875,43.354252756747975,154.0865108700249,172.5369443857157,50.02709452163143,-49.972905478368574,-4.58337765271196,-5.758527957699752,-0.002744911873514111,-523980900.0,1.0
634,2022-07-14,META,161.0491304779075,162.4176735911158,157.11330389023334,157.8824920654297,23765200.0,0.0,0.0,-5.434234619140625,5.434234619140625,0.0,34.735589464507,154.83571462488626,172.5369443857157,17.21223599552134,-82.78776400447866,-4.874154159216317,-5.581653198003066,-0.019844874413144753,-547746100.0,-1.0
635,2022-07-15,META,160.36984180135687,164.80513841842395,159.65061893079425,164.5254364013672,23342800.0,0.0,0.0,6.6429443359375,0.0,6.6429443359375,49.028116596911914,154.83571462488626,172.5369443857157,54.74038757421834,-45.25961242578166,-4.516519077792424,-5.368626373960938,0.029182054118650935,-524403300.0,1.0
636,2022-07-18,META,166.57326265091243,171.5080292126426,165.46443852371144,167.05274963378906,23574300.0,0.0,0.0,2.527313232421875,0.0,2.527313232421875,53.49851089567241,154.83571462488626,172.5369443857157,69.01800142686996,-30.98199857313005,-3.9832469373610593,-5.091550486640962,-0.005707841661522495,-500829000.0,1.0
637,2022-07-19,META,170.18941938388966,176.30294314019665,169.33033029108992,175.59368896484375,25933700.0,0.0,0.0,8.540939331054688,0.0,8.540939331054688,65.34877876290989,154.83571462488626,176.30294314019665,96.69610739529298,-3.30389260470702,-2.8387374680968662,-4.640987882932143,0.03540075335683768,-474895300.0,1.0
638,2022-07-20,META,177.3018797723855,183.40540425319057,176.51270857560905,182.89593505859372,24784300.0,0.0,0.0,7.302246093749972,0.0,7.302246093749972,72.30996876142112,154.83571462488626,183.40540425319057,98.21674928490609,-1.7832507150939074,-1.3271907883036818,-3.978228464006451,0.06330204944980267,-450111000.0,1.0
639,2022-07-21,META,180.4385593887184,183.6551478058561,178.6804150160518,182.97586059570312,27195800.0,0.0,0.0,0.07992553710940342,0.0,0.07992553710940342,72.38004405547574,154.83571462488626,183.6551478058561,97.64295430139991,-2.357045698600095,-0.12143050016990742,-3.2068688712391427,0.07192174291357856,-422915200.0,1.0
640,2022-07-22,META,172.88656677917177,175.41388395948903,168.23150235306818,169.09059143066406,42583900.0,0.0,0.0,-13.885269165039062,13.885269165039062,0.0,48.01991754631375,156.85357517652852,183.6551478058561,45.65782920045969,-54.34217079954031,-0.28299649898639245,-2.622094396788593,0.039231318207778365,-465499100.0,-1.0
641,2022-07-25,META,168.8208734382059,170.3892166795017,164.63531206621525,166.47335815429688,26166300.0,0.0,0.0,-2.6172332763671875,2.6172332763671875,0.0,44.74471277420993,157.11330389023334,183.6551478058561,35.26527506460893,-64.73472493539107,-0.6151325577150999,-2.220702028973894,0.02070182010534083,-491665400.0,-1.0
642,2022-07-26,META,165.7641196773295,165.8240536434423,157.78258293329435,158.98130798339844,28468400.0,0.0,0.0,-7.4920501708984375,7.4920501708984375,0.0,36.51794051015601,157.11330389023334,183.6551478058561,7.037959002032915,-92.9620409979671,-1.4659886483236448,-2.0697593528438443,-0.026546078832116793,-520133800.0,-1.0
643,2022-07-27,META,162.4176715800725,170.68889461168183,161.8482836338804,169.4002685546875,43846600.0,0.0,0.0,10.418960571289062,0.0,10.418960571289062,50.9800652653169,157.11330389023334,183.6551478058561,46.29280732534918,-53.70719267465082,-1.2847788690567086,-1.9127632560864172,0.07295157517835871,-476287200.0,1.0
644,2022-07-28,META,160.8892880711679,161.33880806206784,154.6858786629933,160.54965209960938,73214300.0,0.0,0.0,-8.850616455078125,8.850616455078125,0.0,41.674398978109906,154.6858786629933,183.6551478058561,20.241357859940134,-79.75864214005986,-1.834185223773602,-1.8970476496238542,-0.024165164905314174,-549501500.0,-1.0
645,2022-07-29,META,157.5228719801094,159.97027225694694,155.00553857751976,158.93138122558594,42065400.0,0.0,0.0,-1.6182708740234375,1.6182708740234375,0.0,40.12903286871379,154.6858786629933,183.6551478058561,14.655193894108317,-85.34480610589168,-2.3728202629006887,-1.9922021722792214,-0.04861559253593062,-591566900.0,-1.0
646,2022-08-01,META,157.08333063802405,165.014917466451,155.0654673692088,159.76048278808594,40596700.0,0.0,0.0,0.8291015625,0.0,0.8291015625,41.41332931306656,154.6858786629933,183.6551478058561,17.517197620924005,-82.48280237907599,-2.7016486729854705,-2.134091472420472,-0.09016956287038214,-550970200.0,1.0
647,2022-08-02,META,158.14220562003942,162.06804815975124,157.84252053994734,160.0202178955078,27374500.0,0.0,0.0,0.259735107421875,0.0,0.259735107421875,41.86410882550423,154.6858786629933,183.6551478058561,18.413786023416947,-81.58621397658305,-2.907770291513458,-2.288827236239069,-0.1250750442089229,-523595700.0,1.0
648,2022-08-03,META,162.51756906336394,169.36029967671064,161.39876101691556,168.62109375,31721900.0,0.0,0.0,8.600875854492188,0.0,8.600875854492188,55.07220882359858,154.6858786629933,183.6551478058561,48.1034402983547,-51.89655970164531,-2.3500225437230142,-2.3010662977358582,-0.07845169739313806,-491873800.0,1.0
649,2022-08-04,META,168.12162288292646,171.9675331453332,166.62321272397455,170.38922119140625,23938200.0,0.0,0.0,1.76812744140625,0.0,1.76812744140625,57.36959631128336,154.6858786629933,183.6551478058561,54.206899217827875,-45.793100782172125,-1.7452140977511306,-2.1898958577389127,0.007680082905586749,-467935600.0,1.0
650,2022-08-05,META,166.81300865551958,171.42810692559783,165.62426752713802,166.93287658691406,25832700.0,0.0,0.0,-3.4563446044921875,3.4563446044921875,0.0,51.436982905285426,154.6858786629933,183.6551478058561,42.27582637147085,-57.72417362852915,-1.5271899929425103,-2.0573546847796322,0.0027603121467116853,-493768300.0,-1.0
651,2022-08-08,META,167.82193436811673,177.321849094113,166.95286137134755,170.06954956054688,27299100.0,0.0,0.0,3.1366729736328125,0.0,3.1366729736328125,56.18179433331608,154.6858786629933,183.6551478058561,53.103413902810416,-46.896586097189584,-1.0887528319250066,-1.863634314208707,0.06974556768841222,-466469200.0,1.0
652,2022-08-09,META,168.77093242127586,169.350319527528,166.4234322543036,168.35137939453125,18655100.0,0.0,0.0,-1.718170166015625,1.718170166015625,0.0,52.91418415952842,154.6858786629933,183.6551478058561,47.17240419199438,-52.82759580800561,-0.8699013798255351,-1.6648877273320728,-0.0061917797953056075,-485124300.0,-1.0
653,2022-08-10,META,175.80347041325956,180.28870162347977,173.76562411133474,178.15097045898438,30262100.0,0.0,0.0,9.799591064453125,0.0,9.799591064453125,65.94789938779053,154.6858786629933,180.28870162347977,91.65040836397372,-8.349591636026272,0.0932045623874842,-1.3132692693881616,0.10963161943480682,-454862200.0,1.0
654,2022-08-11,META,179.51952807477204,182.9059343285563,176.1830566307813,177.3018798828125,24079100.0,0.0,0.0,-0.849090576171875,0.849090576171875,0.0,64.17200270554534,154.6858786629933,182.9059343285563,80.14158968303369,-19.858410316966317,0.7789792759692205,-0.8948195603166851,0.11558761092720649,-478941300.0,-1.0
655,2022-08-12,META,180.61835429019752,181.267674490874,178.72037422616253,180.3086853027344,21274000.0,0.0,0.0,3.0068054199219034,0.0,3.0068054199219034,67.72343285741164,154.6858786629933,182.9059343285563,90.79644258465682,-9.203557415343177,1.5472473793701624,-0.4064061723793155,0.1286188058276252,-457667300.0,1.0
656,2022-08-15,META,178.77032564319606,181.24769280442305,178.01112141769542,180.69827270507807,15878700.0,0.0,0.0,0.38958740234366473,0.0,0.38958740234366473,68.19476476848848,154.6858786629933,182.9059343285563,92.17697636871692,-7.823023631283073,2.162612326093324,0.10739752731521257,0.1292215138906565,-441788600.0,1.0
657,2022-08-16,META,179.24981817195896,180.798178411668,176.85235273035946,179.27978515625,21156700.0,0.0,0.0,-1.4184875488280682,1.4184875488280682,0.0,64.25290813495263,154.6858786629933,182.9059343285563,87.1504535098019,-12.849546490198097,2.506935586552686,0.5873051391627074,0.06321090184631784,-462945300.0,-1.0
658,2022-08-17,META,176.5726521773521,177.95119443662148,173.985400894691,174.66468811035156,20118100.0,0.0,0.0,-4.6150970458984375,4.6150970458984375,0.0,52.796290570883336,155.00553857751976,182.9059343285563,70.46190207571317,-29.53809792428683,2.3799814570368483,0.9458404027375359,0.025092355543678835,-483063400.0,-1.0
659,2022-08-18,META,174.15521588015045,175.57370901343464,171.67784866445808,174.47488403320312,18844500.0,0.0,0.0,-0.1898040771484375,0.1898040771484375,0.0,52.35331434955813,155.0654673692088,182.9059343285563,69.71656291662009,-30.283437083379905,2.238252667586579,1.2043228557073447,0.04517988068313361,-501907900.0,-1.0
660,2022-08-19,META,170.01959844417806,172.13736177722112,166.8729432915064,167.781982421875,26240800.0,0.0,0.0,-6.692901611328125,6.692901611328125,0.0,39.02954050475665,157.84252053994734,182.9059343285563,39.65725485665896,-60.342745143341034,1.567800150710866,1.277018314708049,-0.013450774371913443,-528148700.0,-1.0
661,2022-08-22,META,165.3145982246075,165.3145982246075,162.08801081303136,162.87718200683594,19499700.0,0.0,0.0,-4.9048004150390625,4.9048004150390625,0.0,32.11784921334299,161.39876101691556,182.9059343285563,6.874083211670526,-93.12591678832948,0.6333856889599758,1.1482917895584344,-0.032516498572111696,-547648400.0,-1.0
662,2022-08-23,META,162.30778255605438,164.87506591963992,160.52967040429985,160.93923950195312,18111800.0,0.0,0.0,-1.9379425048828125,1.9379425048828125,0.0,29.718542059739733,160.52967040429985,182.9059343285563,1.8303730195517207,-98.16962698044827,-0.2605165591130856,0.8665301198241303,-0.09661317540222947,-565760200.0,-1.0
663,2022-08-24,META,160.42979068230454,165.2846403149504,159.60066854680346,163.0869598388672,20891500.0,0.0,0.0,2.1477203369140625,0.0,2.1477203369140625,35.846869936127234,159.60066854680346,182.9059343285563,14.959242793932702,-85.0407572060673,-0.7865709335120243,0.5359099091568993,-0.08017354386394915,-544868700.0,1.0
664,2022-08-25,META,165.00491436720773,168.7010048409321,163.84615546392752,168.60110473632812,15550500.0,0.0,0.0,5.5141448974609375,0.0,5.5141448974609375,49.01663622222635,159.60066854680346,182.9059343285563,38.619753466067195,-61.380246533932805,-0.7498846517617039,0.27875099697317857,-0.064930763300445,-529318200.0,1.0
665,2022-08-26,META,168.30143170315836,170.7388481007227,161.49865174072391,161.60853576660156,24023600.0,0.0,0.0,-6.9925689697265625,6.9925689697265625,0.0,37.69417281234204,159.60066854680346,182.9059343285563,8.615508780724513,-91.38449121927549,-1.2704062016708235,-0.03108044275562195,-0.10564426904972868,-553341800.0,-1.0
666,2022-08-29,META,160.48972326251754,162.8771895384985,158.84146291971692,159.0012969970703,20052700.0,0.0,0.0,-2.60723876953125,2.60723876953125,0.0,34.28682372627753,158.84146291971692,182.9059343285563,0.6641910999743981,-99.3358089000256,-1.871728914460732,-0.3992101370966441,-0.11311084594119813,-573394500.0,-1.0
667,2022-08-30,META,160.1800602601155,161.4886694268697,155.74476352454576,156.99343872070312,19567900.0,0.0,0.0,-2.0078582763671875,2.0078582763671875,0.0,31.73755273350767,155.74476352454576,182.9059343285563,4.597280452921377,-95.40271954707862,-2.4816910384733433,-0.8157063173719841,-0.10117242117355685,-592962400.0,-1.0
668,2022-08-31,META,166.89293575382789,167.66210868347596,161.96815295967025,162.75730895996094,40953000.0,0.0,0.0,5.7638702392578125,0.0,5.7638702392578125,45.22675501711917,155.74476352454576,181.267674490874,27.475492292656835,-72.52450770734316,-2.471505387656748,-1.146866131428937,-0.06715909363213735,-552009400.0,1.0
669,2022-09-01,META,163.40662597245654,167.1826183907892,160.1800536663398,165.1847381591797,30145700.0,0.0,0.0,2.42742919921875,0.0,2.42742919921875,50.02555527993753,155.74476352454576,181.24769280442305,37.01525629090145,-62.98474370909856,-2.2417192236452763,-1.365836749872205,-0.015479875879429894,-521863700.0,1.0
670,2022-09-02,META,167.27251805508917,167.75200503905106,159.0512452332473,160.15008544921875,22634200.0,0.0,0.0,-5.0346527099609375,5.0346527099609375,0.0,41.35473312102413,155.74476352454576,180.798178411668,17.58371840533954,-82.41628159466046,-2.437764547187612,-1.5802223093352867,-0.016743269523798232,-544497900.0,-1.0
671,2022-09-06,META,159.93032292723004,161.5186340957352,157.52287352533713,158.37196350097656,19339800.0,0.0,0.0,-1.7781219482421875,1.7781219482421875,0.0,38.62642857403409,155.74476352454576,177.95119443662148,11.83080697133616,-88.16919302866384,-2.7054247174698105,-1.8052627909621917,-0.01595183380337406,-563837700.0,-1.0
672,2022-09-07,META,157.59278389332485,160.7894043912853,156.64379385163744,160.22000122070312,16831200.0,0.0,0.0,1.8480377197265625,0.0,1.8480377197265625,43.126071461850536,155.74476352454576,175.57370901343464,22.569216798064517,-77.43078320193548,-2.736877365476772,-1.9915857058651079,-0.017579324680505826,-547006500.0,1.0
673,2022-09-08,META,158.54178919716333,162.05804735716714,157.5728160855248,161.8882293701172,22530800.0,0.0,0.0,1.6682281494140625,0.0,1.6682281494140625,47.16106831387456,155.74476352454576,172.13736177722112,37.477071974046474,-62.522928025953526,-2.5972524502155068,-2.112719054735188,-0.03981513274606985,-524475700.0,1.0
674,2022-09-09,META,163.07697766181758,169.3603044282229,162.8472256978225,168.97071838378906,22086800.0,0.0,0.0,7.082489013671875,0.0,7.082489013671875,60.78868130218777,155.74476352454576,170.7388481007227,88.20781817022102,-11.792181829778983,-1.893277374072909,-2.068830718602732,0.04555565448486032,-502388900.0,1.0
675,2022-09-12,META,167.2125862588688,171.20834674321253,167.1027022358447,168.7809295654297,23220400.0,0.0,0.0,-0.189788818359375,0.189788818359375,0.0,60.307762674276596,155.74476352454576,171.20834674321253,84.30236289055824,-15.697637109441755,-1.3352939717024128,-1.9221233692226682,0.06150662134875273,-525609300.0,-1.0
676,2022-09-13,META,161.36877151199351,161.4586877022976,152.5081780065659,152.9676971435547,44444100.0,0.0,0.0,-15.813232421875,15.813232421875,0.0,34.25442058272829,152.5081780065659,171.20834674321253,2.457299415102374,-97.54270058489763,-2.1443632476990047,-1.9665713449179356,-0.025642737747214817,-570053400.0,-1.0
677,2022-09-14,META,153.1674927621879,153.3772616547184,148.89203020286146,151.30946350097656,43064200.0,0.0,0.0,-1.658233642578125,1.658233642578125,0.0,32.55284163113653,148.89203020286146,171.20834674321253,10.832582042578744,-89.16741795742126,-2.886092815127995,-2.1504756389599478,-0.07033690549528926,-613117600.0,-1.0
678,2022-09-15,META,149.6412297755544,154.03656011107756,148.54238957036546,149.39149475097656,34606300.0,0.0,0.0,-1.91796875,1.91796875,0.0,30.52893337651858,148.54238957036546,171.20834674321253,3.7461695269957502,-96.25383047300426,-3.587330191639012,-2.437846549495761,-0.09560957982077023,-647723900.0,-1.0
679,2022-09-16,META,147.89309316049597,148.42253022382448,144.1370684182503,146.13494873046875,40122800.0,0.0,0.0,-3.2565460205078125,3.2565460205078125,0.0,27.21411504076552,144.1370684182503,171.20834674321253,7.380073775002432,-92.61992622499756,-4.355632602338915,-2.821403760064392,-0.08751251477286281,-687846700.0,-1.0
680,2022-09-19,META,145.08606122861812,148.42251740360336,144.94621022854736,147.8631134033203,22169500.0,0.0,0.0,1.7281646728515625,0.0,1.7281646728515625,31.75161162977352,144.1370684182503,171.20834674321253,13.7638309515449,-86.2361690484551,-4.770082924356245,-3.211139592922763,-0.06635549541312247,-665677200.0,1.0
681,2022-09-20,META,145.62548116577068,148.682235319754,145.0660771693052,145.93515014648438,23217400.0,0.0,0.0,-1.9279632568359375,1.9279632568359375,0.0,29.39290869697591,144.1370684182503,171.20834674321253,6.6420274161049955,-93.357972583895,-5.194232285189827,-3.6077581313761766,-0.08915772665949095,-688894600.0,-1.0
682,2022-09-21,META,146.2348387929307,149.44144318041447,141.84949241870495,141.9693603515625,38338600.0,0.0,0.0,-3.965789794921875,3.965789794921875,0.0,24.987302344106965,141.84949241870495,171.20834674321253,0.4082854580516934,-99.5917145419483,-5.783708533962169,-4.042948211893376,-0.12304087268145447,-727233200.0,-1.0
683,2022-09-22,META,141.3999818729749,144.42676932073678,140.7206946419703,142.66864013671875,34418500.0,0.0,0.0,0.69927978515625,0.0,0.69927978515625,27.20713941734263,140.7206946419703,171.20834674321253,6.389293240029689,-93.61070675997031,-6.12385471855373,-4.459129513225447,-0.15566056946819318,-692814700.0,1.0
684,2022-09-23,META,141.27010871750082,142.46883380259325,138.74279145520362,140.2611846923828,31710700.0,0.0,0.0,-2.4074554443359375,2.4074554443359375,0.0,24.34523291642074,138.74279145520362,171.20834674321253,4.676935982487299,-95.3230640175127,-6.5126110797100125,-4.86982582652236,-0.16897492475292297,-724525400.0,-1.0
685,2022-09-26,META,139.9714894431433,142.08925293372994,136.04566195599782,136.2254638671875,30497000.0,0.0,0.0,-4.0357208251953125,4.0357208251953125,0.0,20.22933236055303,136.04566195599782,171.20834674321253,0.5113429542645775,-99.48865704573542,-7.0649121056529225,-5.308843082348473,-0.10944946932590094,-755022400.0,-1.0
686,2022-09-27,META,137.77381111765135,139.2722212062545,133.97783584466688,134.25753784179688,30826500.0,0.0,0.0,-1.967926025390625,1.967926025390625,0.0,18.472197619158422,133.97783584466688,171.20834674321253,0.7512709075956207,-99.24872909240437,-7.574100210693587,-5.761894508017496,-0.11269569836965043,-785848900.0,-1.0
687,2022-09-28,META,134.47731802973672,141.87946819475164,134.12769812302955,141.4599151611328,32658500.0,0.0,0.0,7.2023773193359375,0.0,7.2023773193359375,40.35166878456679,133.97783584466688,171.20834674321253,20.096633475846833,-79.90336652415316,-7.312173922812548,-6.071950390976507,-0.05309257801500045,-753190400.0,1.0
688,2022-09-29,META,139.21229696734983,139.69178396126895,135.0567023730727,136.2654266357422,38985400.0,0.0,0.0,-5.194488525390625,5.194488525390625,0.0,32.985121214146076,133.97783584466688,171.20834674321253,6.144398064558024,-93.85560193544198,-7.438006332920537,-6.345161579365314,-0.06753704148437423,-792175800.0,-1.0
689,2022-09-30,META,135.9058120725322,140.8405789110467,135.3563919349738,135.53619384765625,33166400.0,0.0,0.0,-0.7292327880859375,0.7292327880859375,0.0,32.03771689605074,133.97783584466688,161.4586877022976,5.670704864109409,-94.32929513589059,-7.510001754815136,-6.578129614455279,-0.08336710401897474,-825342200.0,-1.0
690,2022-10-03,META,136.9946458109859,139.4720130110664,135.95575480534455,138.4630889892578,27723100.0,0.0,0.0,2.9268951416015625,0.0,2.9268951416015625,40.01652111606049,133.97783584466688,154.03656011107756,22.360610201425946,-77.63938979857406,-7.247339943982581,-6.711971680360741,-0.051201243495664905,-797619100.0,1.0
691,2022-10-04,META,140.34110126811484,142.2390813763745,139.1923109982807,140.13131713867188,34670700.0,0.0,0.0,1.6682281494140625,0.0,1.6682281494140625,44.315822090787606,133.97783584466688,154.03656011107756,30.67733128127843,-69.32266871872157,-6.825882029010842,-6.7347537500907615,-0.012946759838454058,-762948400.0,1.0
692,2022-10-05,META,138.0934814775848,140.06139464506106,134.6371421107771,138.8326873779297,27979300.0,0.0,0.0,-1.2986297607421875,1.2986297607421875,0.0,41.63537932828133,133.97783584466688,149.44144318041447,31.395336339404643,-68.60466366059535,-6.521486483401816,-6.692100296752972,-0.026887147414548007,-790927700.0,-1.0
693,2022-10-06,META,137.57403218596087,141.3000745017143,136.45522414838945,138.922607421875,36231100.0,0.0,0.0,0.0899200439453125,0.0,0.0899200439453125,41.916066659858636,133.97783584466688,149.44144318041447,31.976830954425306,-68.02316904557469,-6.201507900964913,-6.59398181759536,-0.009543461888216198,-754696600.0,1.0
694,2022-10-07,META,136.61503713379022,138.14341420635472,132.29962400025974,133.3085479736328,33214800.0,0.0,0.0,-5.6140594482421875,5.6140594482421875,0.0,31.13078262500821,132.29962400025974,149.44144318041447,5.885746213803927,-94.11425378619607,-6.32798502383352,-6.540782458842993,-0.021412413000836072,-787911400.0,-1.0
695,2022-10-10,META,133.408457483318,135.96574177870428,131.73023013783526,133.648193359375,24024000.0,0.0,0.0,0.3396453857421875,0.0,0.3396453857421875,32.3459647935269,131.73023013783526,149.44144318041447,10.829090118947788,-89.17090988105222,-6.327868782789523,-6.4981997236322995,-0.004538623992493385,-763887400.0,1.0
696,2022-10-11,META,131.4804847474187,132.5193909372118,126.85539505100434,128.40374755859375,38481400.0,0.0,0.0,-5.24444580078125,5.24444580078125,0.0,24.609523496561863,126.85539505100434,144.42676932073678,8.811789469742996,-91.18821053025701,-6.674025473490502,-6.53336487360394,-0.09229588175326675,-802368800.0,-1.0
697,2022-10-12,META,128.183998718876,129.53255868484996,126.11618543138692,127.36486053466795,34605200.0,0.0,0.0,-1.0388870239257955,1.0388870239257955,0.0,23.333892830978115,126.11618543138692,142.46883380259325,7.635919729550915,-92.3640802704491,-6.952047740338543,-6.617101446950861,-0.06531786030264874,-836974000.0,-1.0
698,2022-10-13,META,123.39907153593884,131.001006442318,122.4001314181104,130.1519012451172,34325700.0,0.0,0.0,2.787040710449233,0.0,2.787040710449233,33.934260824302115,122.4001314181104,142.2390813763745,39.07348848257827,-60.92651151742173,-6.868317854458439,-6.667344728452377,-0.03972586546580359,-802648300.0,1.0
699,2022-10-14,META,130.8611523647722,131.65030833258726,126.3858973885403,126.62564849853516,23559400.0,0.0,0.0,-3.5262527465820312,3.5262527465820312,0.0,28.234947356735006,122.4001314181104,142.2390813763745,21.299096420496674,-78.70090357950332,-7.005742537747096,-6.735024290311321,-0.08549166840876288,-826207700.0,-1.0
700,2022-10-17,META,130.16189263858828,134.6471237448599,130.0420094666196,133.89791870117188,29612200.0,0.0,0.0,7.272270202636719,0.0,7.272270202636719,48.72672669556237,122.4001314181104,142.2390813763745,57.95562420012038,-42.04437579987962,-6.453449925868597,-6.678709417422777,-0.04448255083002983,-796595500.0,1.0
701,2022-10-18,META,136.94470255091542,137.693907669136,131.26073061519662,132.6592559814453,25445000.0,0.0,0.0,-1.2386627197265625,1.2386627197265625,0.0,46.137603802076946,122.4001314181104,142.2390813763745,51.71203407900822,-48.28796592099179,-6.046009131279675,-6.5521693601941555,-0.04446669954373994,-822040500.0,-1.0
702,2022-10-19,META,132.74915490339345,136.8547994980393,132.0798668371521,133.0887908935547,30691000.0,0.0,0.0,0.429534912109375,0.0,0.429534912109375,47.25891913672777,122.4001314181104,142.2390813763745,53.877143185150445,-46.12285681484956,-5.62362385811673,-6.3664602597786715,-0.041993284149961285,-791349500.0,1.0
703,2022-10-20,META,132.78910457166396,136.62504626701622,131.1708264337386,131.39059448242188,26356300.0,0.0,0.0,-1.6981964111328125,1.6981964111328125,0.0,43.16007297600875,122.4001314181104,142.2390813763745,45.31723243026992,-54.68276756973008,-5.3640769800040005,-6.165983603823738,-0.014387325646891713,-817705800.0,-1.0
704,2022-10-21,META,126.17611719028058,129.98207639968365,125.3070442112371,129.8721923828125,46348600.0,0.0,0.0,-1.518402099609375,1.518402099609375,0.0,39.61530643903516,122.4001314181104,142.2390813763745,37.66359096837958,-62.33640903162042,-5.220725277782975,-5.976931938615587,-0.028253288590358805,-864054400.0,-1.0
705,2022-10-24,META,127.11513610223342,133.3385290674394,124.43797615294896,129.58251953125,63563400.0,0.0,0.0,-0.2896728515625,0.2896728515625,0.0,38.9118197026592,122.4001314181104,141.3000745017143,38.00216795028588,-61.99783204971412,-5.072025047213202,-5.79595056033511,0.009180199138022482,-927617800.0,-1.0
706,2022-10-25,META,130.74128030206407,138.203363790884,130.45157914797585,137.36424255371094,38433200.0,0.0,0.0,7.7817230224609375,0.0,7.7817230224609375,60.59941643024001,122.4001314181104,141.3000745017143,79.17542962646387,-20.824570373536126,-4.276957012653327,-5.492151850798754,0.07850973947654283,-889184600.0,1.0
707,2022-10-26,META,131.5404328870068,135.40634166926623,128.39377748161664,129.6824188232422,82791500.0,0.0,0.0,-7.68182373046875,7.68182373046875,0.0,43.15026867156662,122.4001314181104,138.203363790884,46.080999338325135,-53.919000661674865,-4.218095191843901,-5.237340519007784,-0.0036071883497945656,-971976100.0,-1.0
708,2022-10-27,META,97.87615541840668,102.39136136625518,96.27784514393562,97.83619689941406,232316600.0,0.0,0.0,-31.846221923828125,31.846221923828125,0.0,18.150503197509295,96.27784514393562,138.203363790884,3.716952838678522,-96.28304716132148,-6.664347990278756,-5.522742013261979,-0.22735876925798437,-1204292700.0,-1.0
709,2022-10-28,META,99.4744583831717,100.7431089746008,97.40665265200374,99.09485626220705,95928300.0,0.0,0.0,1.258659362792983,0.0,1.258659362792983,20.257389404807654,96.27784514393562,138.203363790884,6.719084722584499,-93.2809152774155,-8.40457496390681,-6.099108603390946,-0.2599223556016351,-1108364400.0,1.0
710,2022-10-31,META,98.11589854132488,99.21473113490184,92.5018523956058,93.06126403808594,121361400.0,0.0,0.0,-6.033592224121108,6.033592224121108,0.0,17.73266118787194,92.5018523956058,138.203363790884,1.2240550156902255,-98.77594498430977,-10.153534174232547,-6.909993717559268,-0.298493999912813,-1229725800.0,-1.0
711,2022-11-01,META,94.23002516207924,97.38667203894552,93.45085307289416,95.0990982055664,110189600.0,0.0,0.0,2.0378341674804688,0.0,2.0378341674804688,21.543335135984748,92.5018523956058,138.203363790884,5.683063274421498,-94.3169367255785,-11.245529312062942,-7.777100836460003,-0.28544622302844946,-1119536200.0,1.0
712,2022-11-02,META,94.11014676234127,95.09909533636912,90.38410442338682,90.44403839111328,71821100.0,0.0,0.0,-4.655059814453125,4.655059814453125,0.0,19.199300229127346,90.38410442338682,138.203363790884,0.12533437054276586,-99.87466562945724,-12.344270647693847,-8.690534798706773,-0.31163993322814776,-1191357300.0,-1.0
713,2022-11-03,META,89.98452343494736,90.36411791829934,88.31629534530302,88.81576538085938,60664000.0,0.0,0.0,-1.6282730102539062,1.6282730102539062,0.0,18.391652894125528,88.31629534530302,138.203363790884,1.0012014157560705,-98.99879858424393,-13.194323139450375,-9.591292466855494,-0.3161294673530637,-1252021300.0,-1.0
714,2022-11-04,META,90.2542352854532,91.29313388990616,87.99662855613603,90.69377136230467,55638100.0,0.0,0.0,1.8780059814452983,0.0,1.8780059814452983,22.71810387194708,87.99662855613603,138.203363790884,5.372073674095335,-94.62792632590467,-13.5601435898282,-10.385062691450036,-0.30010797991597127,-1196383200.0,1.0
715,2022-11-07,META,94.67953886662175,96.77731149493104,93.00131923971276,96.61748504638672,81987300.0,0.0,0.0,5.9237136840820455,0.0,5.9237136840820455,35.21776230237096,87.99662855613603,138.203363790884,17.170717135744397,-82.8292828642556,-13.219676571346767,-10.951985467429383,-0.2966329282629123,-1114395900.0,1.0
716,2022-11-08,META,95.81833197504274,97.69634422915838,94.68953241263884,96.36775207519533,52088300.0,0.0,0.0,-0.24973297119139204,0.24973297119139204,0.0,34.94284104545538,87.99662855613603,138.203363790884,16.67330783393711,-83.32669216606288,-12.822199038454514,-11.32602818163441,-0.2568942424913814,-1166484200.0,-1.0
717,2022-11-09,META,101.61219231051426,104.78882226213923,100.63322761945388,101.36245727539062,107677300.0,0.0,0.0,4.994705200195298,0.0,4.994705200195298,44.87370922439137,87.99662855613603,138.203363790884,26.621585045832923,-73.37841495416708,-11.966225090135865,-11.454067563334702,0.03604249232624945,-1058806900.0,1.0
718,2022-11-10,META,107.00646874096692,112.6304988909178,104.49912689776596,111.75143432617188,80671000.0,0.0,0.0,10.38897705078125,0.0,10.38897705078125,59.6545096995985,87.99662855613603,138.203363790884,47.3139821957497,-52.6860178042503,-10.330472729084576,-11.229348596484678,0.12772184693901023,-978135900.0,1.0
719,2022-11-11,META,109.11423122143096,114.77821979799194,108.69467058437192,112.90020751953124,59961700.0,0.0,0.0,1.1487731933593608,0.0,1.1487731933593608,60.98906018806047,87.99662855613603,138.203363790884,49.602068023254965,-50.397931976745035,-8.839534158951707,-10.751385708978086,0.2131815389196312,-918174200.0,1.0
720,2022-11-14,META,110.87235815299836,116.14676059441597,110.68256471890506,114.09893798828124,53395000.0,0.0,0.0,1.19873046875,0.0,1.19873046875,62.48323215794474,87.99662855613603,135.40634166926623,55.05688121305279,-44.9431187869472,-7.475059244212488,-10.096120416024966,0.19978990485950487,-864779200.0,1.0
721,2022-11-15,META,115.946978085481,118.614146345987,114.2887414684979,116.9559097290039,50670500.0,0.0,0.0,2.8569717407226705,0.0,2.8569717407226705,66.05826858778288,87.99662855613603,118.614146345987,94.58402660736672,-5.415973392633279,-6.092933762799049,-9.295483085379784,0.29313011459355165,-814108700.0,1.0
722,2022-11-16,META,114.3786435781866,115.95697079466773,112.5405974182149,113.10999298095705,33287800.0,0.0,0.0,-3.845916748046861,3.845916748046861,0.0,57.5414448457779,87.99662855613603,118.614146345987,82.02286219670474,-17.977137803295264,-5.247433541824236,-8.485873176668674,0.2735350812540913,-847396500.0,-1.0
723,2022-11-17,META,110.292980036061,112.2109431978486,109.68362596570536,111.33187103271484,35093800.0,0.0,0.0,-1.7781219482422017,1.7781219482422017,0.0,53.83845411536783,87.99662855613603,118.614146345987,76.2153308336247,-23.78466916637529,-4.667049262178381,-7.722108393770616,0.22755807108257553,-882490300.0,-1.0
724,2022-11-18,META,113.6793891127622,114.19883462365196,110.50275921490214,111.93124389648438,33357700.0,0.0,0.0,0.5993728637695312,0.0,0.5993728637695312,54.96564951173898,87.99662855613603,118.614146345987,78.17294499386931,-21.827055006130696,-4.111333268959527,-6.999953368808399,0.15849883530652265,-849132600.0,1.0
725,2022-11-21,META,111.40179740595262,112.2509025941526,109.07427274827924,109.74356079101562,24351100.0,0.0,0.0,-2.18768310546875,2.18768310546875,0.0,49.840179435455944,87.99662855613603,118.614146345987,71.02774426112435,-28.972255738875653,-3.803606470861496,-6.360683989219019,0.13879963398319406,-873483700.0,-1.0
726,2022-11-22,META,109.74356453230877,111.5017013149533,108.20519580015836,111.32189178466795,29029000.0,0.0,0.0,1.5783309936523295,0.0,1.5783309936523295,53.45337997927145,87.99662855613603,118.614146345987,76.18273757078941,-23.817262429210583,-3.393257291422856,-5.767198649659787,0.09825565378923917,-844454700.0,1.0
727,2022-11-23,META,111.6015872253702,112.55057725512896,110.61263867775835,112.12103271484376,21343100.0,0.0,0.0,0.7991409301758097,0.0,0.7991409301758097,55.333108035563924,87.99662855613603,118.614146345987,78.79281502925897,-21.207184970741018,-2.96933991536892,-5.207626902801614,0.0033073256813254126,-823111600.0,1.0
728,2022-11-25,META,111.1820394989629,112.61052418947676,110.90232986071057,111.29192352294922,12007600.0,0.0,0.0,-0.8291091918945455,0.8291091918945455,0.0,52.781438897957926,93.00131923971276,118.614146345987,71.41189142199734,-28.588108578002664,-2.6695120485001382,-4.700003931941319,-0.014245181934708029,-835119200.0,-1.0
729,2022-11-28,META,110.66258357852746,111.92125024440746,108.26512580300162,108.66470336914062,23309400.0,0.0,0.0,-2.6272201538085938,2.6272201538085938,0.0,45.166170579066694,94.68953241263884,118.614146345987,58.41336038038217,-41.58663961961783,-2.6137611968552648,-4.2827553849241085,-0.047627390008649684,-858428600.0,-1.0
730,2022-11-29,META,109.42390355132623,110.82242126776865,108.42496341405428,109.34398651123048,23899200.0,0.0,0.0,0.679283142089858,0.0,0.679283142089858,47.42900340910391,100.63322761945388,118.614146345987,48.44445950875013,-51.55554049124987,-2.4861074743266443,-3.9234258028046156,-0.06508369893758126,-834529400.0,1.0
731,2022-11-30,META,109.39393129093494,118.03476458588216,109.26406420171524,117.97482299804688,43348600.0,0.0,0.0,8.630836486816392,0.0,8.630836486816392,67.24544173644286,104.49912689776596,118.614146345987,95.47061659896829,-4.529383401031704,-1.669262401286204,-3.472593122500933,0.04300972786647472,-791180800.0,1.0
732,2022-12-01,META,119.0736562076729,121.07153639653524,118.2745087049128,120.31234741210938,36551400.0,0.0,0.0,2.3375244140625,0.0,2.3375244140625,70.69719510125111,108.20519580015836,121.07153639653524,94.09941794452692,-5.900582055473079,-0.8237919537169489,-2.942832888744136,0.08066402096804448,-754629400.0,1.0
733,2022-12-02,META,117.70511837832689,123.9085357254232,117.485350328392,123.35911560058594,39950500.0,0.0,0.0,3.0467681884765625,0.0,3.0467681884765625,74.7060140834094,108.20519580015836,123.9085357254232,96.50125306175589,-3.4987469382441128,0.09104864097871257,-2.3360565827995665,0.10209724565082312,-714678900.0,1.0
734,2022-12-05,META,121.62095997450014,124.53786330452816,121.22138240104094,122.30023956298828,35474900.0,0.0,0.0,-1.0588760375976562,1.0588760375976562,0.0,70.82074282870552,108.20519580015836,124.53786330452816,86.29970431381645,-13.70029568618355,0.7222977587077963,-1.7243857144980939,0.11441836479029788,-750153800.0,-1.0
735,2022-12-06,META,119.7829103872775,120.4222314380398,113.61944421214416,113.9990463256836,43689200.0,0.0,0.0,-8.301193237304688,8.301193237304688,0.0,48.16278793039066,108.20519580015836,124.53786330452816,35.47400033690203,-64.52599966309796,0.5464314023425914,-1.2702222911299568,0.02404876972621084,-793843000.0,-1.0
736,2022-12-07,META,113.63943188410484,115.75718009252842,112.7603596877252,113.80924987792967,29461100.0,0.0,0.0,-0.18979644775392046,0.18979644775392046,0.0,47.75968390311333,108.20519580015836,124.53786330452816,34.31193389733764,-65.68806610266236,0.3872767753500739,-0.9387224778339506,0.015057096088113342,-823304100.0,-1.0
737,2022-12-08,META,116.26663774006522,117.21562778744608,114.46854250982888,115.207763671875,30619400.0,0.0,0.0,1.3985137939453267,0.0,1.3985137939453267,51.23011802287378,108.20519580015836,124.53786330452816,42.87461230593902,-57.12538769406098,0.36973192133116584,-0.6770315980009273,0.035185303883424224,-792684700.0,1.0
738,2022-12-09,META,115.17779810087087,117.4154218204801,113.74931343413776,115.77716064453124,26033400.0,0.0,0.0,0.5693969726562358,0.0,0.5693969726562358,52.70609469024949,108.20519580015836,124.53786330452816,46.36085833711485,-53.63914166288515,0.39719446410742876,-0.46218638557925606,0.06545324337038094,-766651300.0,1.0
739,2022-12-12,META,115.0579201159312,115.59734868023622,113.02008141343708,114.58841705322266,24747100.0,0.0,0.0,-1.1887435913085795,1.1887435913085795,0.0,49.124727248145625,108.20519580015836,124.53786330452816,39.08253964856914,-60.91746035143086,0.3193557210580167,-0.30587796425180147,0.047962679149744725,-791398400.0,-1.0
740,2022-12-13,META,122.00055651030816,123.16932226587896,118.5142575569382,120.0226593017578,44701100.0,0.0,0.0,5.434242248535142,0.0,5.434242248535142,62.548076355286426,108.26512580300162,124.53786330452816,72.25295373721359,-27.747046262786405,0.6882323714434193,-0.10705589711275726,0.017358248579400826,-746697300.0,1.0
741,2022-12-14,META,119.26345547914094,124.00842085666014,119.26345547914094,121.46112060546876,36922000.0,0.0,0.0,1.438461303710966,0.0,1.438461303710966,65.3411082900092,108.26512580300162,124.53786330452816,81.09265451636047,-18.90734548363954,1.0841442389724705,0.13118413010428837,0.009548256833726843,-709775300.0,1.0
742,2022-12-15,META,118.20458332874875,118.50426078461167,113.88916242107322,116.02689361572266,34531000.0,0.0,0.0,-5.434226989746108,5.434226989746108,0.0,49.31109403389952,108.26512580300162,124.53786330452816,47.69798450932368,-52.30201549067631,0.9484770940402143,0.2946427228914736,-0.05943802327996306,-744306300.0,-1.0
743,2022-12-16,META,120.10257617966104,123.1793060133916,118.69406692644786,119.3034210205078,67064000.0,0.0,0.0,3.276527404785142,0.0,3.276527404785142,56.701149750885236,108.42496341405428,124.53786330452816,67.51396508635284,-32.48603491364716,1.092751719127648,0.4542645221387085,-0.024503783093057896,-677242300.0,1.0
744,2022-12-19,META,116.70617316606334,117.67514627793896,114.20882292774806,114.3586654663086,29769900.0,0.0,0.0,-4.9447555541992045,4.9447555541992045,0.0,45.22086649427898,109.26406420171524,124.53786330452816,33.3551674360775,-66.6448325639225,0.7988809512278294,0.5231878079565326,0.003154580254975059,-707012200.0,-1.0
745,2022-12-20,META,113.13996168625007,117.20564772589532,112.34080653070018,116.96589660644533,28742500.0,0.0,0.0,2.607231140136733,0.0,2.607231140136733,51.22857432469963,112.34080653070018,124.53786330452816,37.91972245033331,-62.08027754966668,0.7675205138373826,0.5720543491327027,0.027736293244190913,-678269700.0,1.0
746,2022-12-21,META,116.57630992432026,120.21245138163488,115.49746037794844,119.63307189941406,20392800.0,0.0,0.0,2.667175292968736,0.0,2.667175292968736,56.81856003389034,112.34080653070018,124.53786330452816,59.78709047547744,-40.21290952452256,0.9469698170114924,0.6470374427084606,0.038411545250915946,-657876900.0,1.0
747,2022-12-22,META,117.0757742823392,118.49427498758637,114.2587635626776,116.99586486816406,23618100.0,0.0,0.0,-2.63720703125,2.63720703125,0.0,50.247970409707136,112.34080653070018,124.53786330452816,38.16542321466066,-61.834576785339344,0.8663968330623248,0.6909093207792335,0.01052629220520096,-681495000.0,-1.0
748,2022-12-23,META,115.90702230457848,118.05474511278892,115.41754377383091,117.9148941040039,17796600.0,0.0,0.0,0.9190292358398438,0.0,0.9190292358398438,52.458615161975544,112.34080653070018,124.00842085666014,47.77401290083453,-52.22598709916547,0.8667092562851053,0.7260693078804079,0.029029784478445286,-663698400.0,1.0
749,2022-12-27,META,117.80500895156494,118.4742970045276,115.92700426493134,116.75611877441406,21392300.0,0.0,0.0,-1.1587753295898438,1.1587753295898438,0.0,49.273401846341905,112.34080653070018,124.00842085666014,37.84245965252723,-62.157540347472775,0.7646390861561514,0.7337832635355567,-0.02721603192553068,-685090700.0,-1.0
750,2022-12-28,META,116.12678894351497,118.02477669567062,115.38757538872257,115.4974594116211,19612500.0,0.0,0.0,-1.2586593627929688,1.2586593627929688,0.0,45.78891424445333,112.34080653070018,124.00842085666014,27.05482708575217,-72.94517291424782,0.575549869252626,0.7021365846789706,-0.04909934277009431,-704703200.0,-1.0
751,2022-12-29,META,116.2766284691434,120.90171836082304,115.64729133226844,120.13253784179688,22366200.0,0.0,0.0,4.635078430175781,0.0,4.635078430175781,58.31472466107977,112.34080653070018,124.00842085666014,66.7808439104849,-33.21915608951508,0.7905939187958637,0.7198280515023493,0.03538528093040205,-682337000.0,1.0
752,2022-12-30,META,118.03476601595814,120.2923651573271,117.61520538126018,120.2124481201172,19583800.0,0.0,0.0,0.07991027832032671,0.0,0.07991027832032671,58.50544731381949,112.34080653070018,124.00842085666014,67.46573352105877,-32.534266478941234,0.956440715744094,0.7671505843506983,0.007619455434166866,-662753200.0,1.0
